出征收	出征收
着眼于	著眼於
八蜡	八蜡
一面食	一面食
嬖幸	嬖倖
揮杆	揮桿
对表扬	對表揚
圆	圓
合府上	合府上
场	場
圹	壙
时间不准	時間不準
锦绣花园	錦綉花園
圣	聖
开辟	開闢
恋恋不舍	戀戀不捨
争	爭
亏	虧
于	於
云	雲
亚	亞
凶猛	兇猛
𩙩	𩘀
干仗	幹仗
注疏	註疏
产	產
亩	畝
检	檢
棁	梲
棂	欞
亲	親
亵	褻
古语云	古語云
亸	嚲
布隆迪	蒲隆地
亿	億
奇丑	奇醜
夸能	誇能
托辞	託辭
神荼郁垒	神荼鬱壘
树梁	樹樑
浒	滸
于洋	于洋
采买	採買
制备	製備
搭伙	搭夥
高峰时间	尖峰時間
采行	採行
保险柜	保險柜
三统历	三統曆
㑩	儸
𬴂	騑
𬴃	騞
孫杰	孫杰
𬴊	驎
〇余	〇餘
𧳕	𧳟
小价	小价
郁郁	鬱郁
千只够	千只夠
二里头	二里頭
㑈	倲
頁面	頁面
小仆	小僕
布谷	布穀
㑇	㑳
乔岳	喬嶽
周杰	周杰
泡制	泡製
占了卜	占了卜
㑔	㑯
騰格里	騰格里
天地志狼	天地志狼
贵价	貴价
洋烟	洋菸
征候	徵候
于震中	於震中
开吊	開弔
浍	澮
懈松	懈鬆
版图里	版圖裡
于帅	于帥
测	測
几榻	几榻
酦	醱
了然	瞭然
博尔术	博爾朮
斗合	鬥合
征招	徵招
标准杆	標準桿
有征服	有征服
空氣質素	空氣品質
各类钟	各類鐘
广部	广部
埃塞俄比亚	衣索比亞
修筑后	修築後
埃塞俄比亞	衣索比亞
𬩽	鄩
嫩姜	嫩薑
伙友	夥友
杜塞尔多夫	杜塞道夫
敢干	敢幹
于康震	于康震
经文里	經文裡
中型钟面	中型鐘面
反冲	反衝
好斗	好鬥
㻅	璯
干姊	乾姊
疑系	疑係
薛定谔	薛丁格
绥棱	綏稜
干姜	乾薑
干姐	乾姐
里水镇	裏水鎮
竹几	竹几
哪里	哪裡
郑凯云	鄭凱云
制剂	製劑
蓟	薊
蓝	藍
蓣	蕷
蓠	蘺
蓦	驀
蓥	鎣
格莱美奖	葛萊美獎
赵惠后	趙惠后
当当网	當當網
抵牾	牴牾
刮得	颳得
共和联邦	大英國協
丹棱	丹稜
绪余	緒餘
擊扑	擊扑
帘布	帘布
𣺽	𤁣
𣺼	灙
于佳卉	于佳卉
术	術
巴而术	巴而朮
采砂场	採砂場
吊腰撒跨	弔腰撒跨
机	機
被发缨冠	被髮纓冠
昆仑	崑崙
干血浆	乾血漿
么姓	么姓
𠵸	𡄣
𠵾	㗲
杨雅筑	楊雅筑
内斗	內鬥
掣签	掣籤
征名责实	徵名責實
三只	三隻
三周后	三周後
钟花	鐘花
谷城县	穀城縣
徐干	徐幹
𩖗	䫴
𩖖	顃
𩖕	𩓣
松了	鬆了
蜜里调油	蜜裡調油
斗而铸兵	鬥而鑄兵
郁悒	鬱悒
2只	2隻
富余	富餘
水表示	水表示
耍斗	耍鬥
松些	鬆些
于忠肅集	于忠肅集
一出电影	一齣電影
砾	礫
砺	礪
砻	礱
流動支付	行動支付
卫后庄公	衛後莊公
坚致	堅緻
面包住	面包住
砜	碸
砚	硯
砖	磚
砗	硨
辟谣	闢謠
啮合	嚙合
砀	碭
码	碼
盘回	盤迴
叱咤樂壇	叱咤樂壇
建筑后	建築後
斗雪红	鬥雪紅
葉叶琹	葉叶琹
葉叶琴	葉叶琴
短信	簡訊
庆历	慶曆
髅	髏
划水	划水
䟢	躎
两天后	兩天後
于小伟	于小偉
髌	髕
叶志穗	叶志穗
信托贸易	信托貿易
心系农	心繫农
涂鸿钦	涂鴻欽
立范	立範
于爾岑	于爾岑
万历	萬曆
往复式	往復式
免征	免徵
多冲	多衝
莪术	莪朮
拗别	拗彆
个中高手	箇中高手
丰滨乡	豐濱鄉
夜游	夜遊
巩	鞏
巯	巰
仆憎	僕憎
种丹妮	种丹妮
并行	並行
兰溪市	蘭谿市
邀天之幸	邀天之倖
埔子里	埔子里
侍仆	侍僕
划動	划動
托附	託附
游人	遊人
愿朴	愿樸
复种	複種
游了	遊了
范文虎	范文虎
羟	羥
手冢治虫	手塚治虫
濑	瀨
于右任	于右任
作准	作準
冁	囅
𦝼	膢
干白儿	乾白兒
干贝	乾貝
制做	製做
蒙雾	濛霧
西岳	西嶽
于汉超	于漢超
樸茨茅夫	樸茨茅斯
流動作業系統	行動作業系統
干革命	幹革命
金表明	金表明
么娘	么娘
闯炼	闖鍊
地丑德齐	地醜德齊
撩斗	撩鬥
干货	乾貨
熊杰	熊杰
留发	留髮
只身上已	只身上已
孝惠后	孝惠后
字段	欄位
干醋	乾醋
棱层	稜層
開山辟谷	開山辟谷
不断发	不斷發
丑史	醜史
商标准许	商標准許
推杆	推桿
田里穗	田里穗
电子钟表	電子鐘錶
晒干	曬乾
斗别气	鬥彆氣
老面皮	老面皮
雅爾塔	雅爾達
桑干	桑乾
霍尔木兹	荷姆茲
窗明几亮	窗明几亮
丑逆	醜逆
评断发	評斷發
冈比亚	甘比亞
黃鈺筑	黃鈺筑
肥筑方言	肥筑方言
两周后	兩周後
唁吊	唁弔
㓥	劏
𬶋	鮈
𬶏	鮠
𬶍	鮀
𬶐	鮡
津巴布韦	辛巴威
怀里	懷裡
译注	譯註
咸、甜	鹹、甜
𬶟	鯻
六个	六個
𬶠	鰊
嚼谷	嚼穀
深山何处钟	深山何處鐘
𬶨	鱀
一冲	一衝
𬶮	鱚
𬶭	鰶
津巴布韋	辛巴威
蒙鸿	濛鴻
淀北片	澱北片
𨂺	𨈊
胎发展	胎發展
困兽之斗	困獸之鬥
复述	複述
会里	會裡
划着独木舟	划着獨木舟
扎好根	扎好根
径启	逕啟
千回百转	千迴百轉
揪发	揪髮
借箸代筹	藉箸代籌
间不容发	間不容髮
訚	誾
舍车保帅	捨車保帥
西湖里	西湖里
波黑	波赫
冲口	衝口
于贝尔	于貝爾
𩧭	䭿
秒表明	秒表明
韩制	韓製
范性形变	範性形變
锌制	鋅製
𨤰	𨤻
这只采	這只採
天里昂	天里昂
馬格里布	馬格里布
扎脚	紮腳
诚朴	誠樸
大言非夸	大言非夸
于正昇	于正昇
焙干	焙乾
于正昌	于正昌
电冲	電衝
库尔德族	庫德族
三征七辟	三徵七辟
干女	乾女
恂栗	恂慄
采煤	採煤
言云	言云
𣑶	𣠲
钟漏	鐘漏
饩	餼
毛发	毛髮
贤	賢
姜黄	薑黃
仆吏	僕吏
追凶	追兇
數碼技術	數位技術
危地馬拉	瓜地馬拉
前面店	前面店
惩忿窒欲	懲忿窒欲
中签署	中簽署
陨	隕
千只夠	千只夠
乌兹冲锋枪	烏茲衝鋒槍
珐琅	琺瑯
小几	小几
丽	麗
才干政	才干政
硬干	硬幹
捉奸党	捉奸黨
𠚳	𠠎
上系上	上繫上
孛里海	孛里海
干球温度	幹球溫度
蕰	薀
蕲	蘄
财	財
厄瓜多爾	厄瓜多
烫面	燙麵
马拉多纳	馬拉度納
烹制	烹製
丑类	醜類
诱奸	誘姦
木杆	木桿
秀发	秀髮
巴塞罗那	巴塞隆納
可紧可松	可緊可鬆
注云	注云
𤆡	熓
贠	貟
颁	頒
吊唁	弔唁
面包厢	面包廂
颂	頌
嚣	囂
发及腰	髮及腰
壳里	殼裡
穷追不舍	窮追不捨
𪚐	𪘯
调制	調製
陇	隴
桪	樳
桨	槳
桩	樁
体征	體徵
丑恶	醜惡
𪚏	𪘀
䴓	鳾
档	檔
桠	椏
桡	橈
䴗	鶪
桧	檜
䴕	鴷
䴔	鵁
涌上	湧上
额我略历史	額我略歷史
内面包的	內面包的
凶犯	兇犯
颛	顓
云為	云為
国历	國曆
龙岩	龍巖
专辑里	專輯裡
总数只	總數只
查封后	查封後
向往时	向往時
乱斗	亂鬥
曲车	麴車
奸淫掳掠	奸淫擄掠
伐罪吊民	伐罪弔民
向往日	向往日
频	頻
IP地址	IP位址
焕	煥
打风后	打風後
凶杀	兇殺
项链	項鍊
羁	羈
3字节	3位元組
驵	駔
驴	驢
驷	駟
驶	駛
驱	驅
驰	馳
驳	駁
驲	馹
驽	駑
驼	駝
驿	驛
碍	礙
驹	駒
驸	駙
驻	駐
䙓	襬
䙌	䙡
䙊	𧜵
驭	馭
马	馬
碜	磣
驮	馱
碛	磧
苍术	蒼朮
游戏里	遊戲裡
沤郁	漚鬱
铲平	剷平
门德尔松	孟德爾頌
丑月	丑月
主干	主幹
碱	鹼
收回	收回
熏肉	燻肉
须胡	鬚鬍
曲尘	麴塵
坐台	坐檯
几椅	几椅
斗闲气	鬥閒氣
干坏事	幹壞事
昆承湖	崑承湖
坤范	坤範
么半	么半
山岳	山嶽
冲盹	衝盹
普密蓬	蒲美蓬
漫游	漫遊
干涸	乾涸
7字节	7位元組
心系神	心繫神
慑	懾
珍肴异馔	珍肴異饌
心系祖	心繫祖
干涩	乾澀
舍己为国	捨己為國
钟不扣不鸣	鐘不扣不鳴
征风召雨	徵風召雨
一发千钧	一髮千鈞
下签	下籤
脏器	臟器
么媽	么媽
光致致	光緻緻
催并	催併
犖确	犖确
干屎橛	乾屎橛
冲激	衝激
聘雇	聘僱
历书	曆書
模范三军	模范三軍
准噶尔	準噶爾
于余曲折	于餘曲折
土索面	土索麵
并发现	並發現
余珍	餘珍
于震后	於震後
于蔭霖	于蔭霖
斗鱼	鬥魚
㶉	鸂
痳病	痳病
寄托在	寄托在
大风后	大風後
㶽	煱
瓦格纳	華格納
干鲜	乾鮮
㶶	燶
洞里	洞裡
国历来	國歷來
棒子面	棒子麵
刚干	剛乾
百天后	百天後
精准	精準
后姓	后姓
冲堂	衝堂
制钟	制鐘
姜茶	薑茶
刻半钟	刻半鐘
独立国家联合体	獨立國家國協
干坞	乾塢
亚细安	東協
发钗	髮釵
载	載
吉布堤	吉布地
木制	木製
悦	悅
悫	愨
悯	憫
悮	悞
悭	慳
悬	懸
笔杆	筆桿
缩短发	縮短發
沙羡	沙羡
方便面	方便麵
于洪区	于洪區
心系何	心繫何
爆发	爆發
心系选	心繫選
制成	製成
复决	複決
齐王舍牛	齊王捨牛
汤面	湯麵
三杆	三桿
夸下海口	誇下海口
明目张胆	明目張胆
千个	千個
于归	于歸
复写	複寫
自制不	自制不
炆面	炆麵
陈炼	陳鍊
主钟差	主鐘差
心系你	心繫你
锎	鐦
锏	鐧
锌	鋅
锍	鋶
锊	鋝
锋	鋒
锈	鏽
锉	銼
無煙環境	無菸環境
锇	鋨
锄	鋤
锅	鍋
锂	鋰
锃	鋥
销	銷
锁	鎖
锞	錁
锟	錕
锜	錡
锝	鍀
锚	錨
锛	錛
锘	鍩
错	錯
锖	錆
锗	鍺
锔	鋦
锕	錒
锒	鋃
锓	鋟
锐	銳
锑	銻
键	鍵
锯	鋸
锬	錟
锭	錠
锪	鍃
锫	錇
锨	杴
锩	錈
锦	錦
锧	鑕
锤	錘
锥	錐
锢	錮
锣	鑼
锠	錩
锡	錫
锾	鍰
锿	鎄
锼	鎪
锽	鍠
锺	鍾
实验里	實驗裡
锸	鍤
锹	鍬
锶	鍶
锷	鍔
锴	鍇
锵	鏘
锲	鍥
锳	鍈
锰	錳
锱	錙
戏里	戲裡
𨄄	𨈌
挥手表	揮手表
卷袖	捲袖
冲破	衝破
语里	語裡
理一个发	理一個髮
缙	縉
这只限	這只限
于西翰	于西翰
心系风	心繫風
𩬣	𩭙
𩬤	𩰀
标注	標註
水表	水錶
亿只	億隻
里运河	裏運河
言里	言裡
跃	躍
嵝	嶁
9只支援	9只支援
天后宫	天后宮
嵘	嶸
嵚	嶔
黑长发	黑長髮
跞	躒
林郁方	林郁方
么雞	么雞
数天后	數天後
干擦	乾擦
不通吊庆	不通弔慶
发踊冲冠	髮踴沖冠
闲	閒
𫛸	鶗
菠棱菜	菠稜菜
泰坦尼克号	鐵達尼號
𫛶	鶒
灏	灝
闿	闓
兽欲	獸慾
𫛢	鸋
养脏	養臟
標準杆	標準桿
蜂后	蜂后
灿	燦
灾	災
𫛞	鴃
百只可	百只可
灵	靈
薩拉熱窩	塞拉耶佛
闺	閨
灯	燈
余力为	余力為
灭	滅
游丝	遊絲
于来山	于來山
雇农	僱農
沟大曲	溝大麯
于明涛	于明濤
嘤	嚶
书签	書籤
片言只语	片言隻語
小型钟表面	小型鐘表面
于永波	于永波
的钟	的鐘
嘱	囑
阿里	阿里
好凶	好兇
夸强说会	誇強說會
甲肝	A肝
困觉	睏覺
这里	這裡
风起云涌	風起雲湧
大伙儿	大伙兒
主仆	主僕
塞拉利昂	獅子山
发肤	髮膚
游玩	遊玩
于熙珍	于熙珍
七扎	七紮
𬍤	璕
发纱	髮紗
筑陽	筑陽
米面	米麵
注上	註上
㺍	獱
吊喉	弔喉
山谷	山谷
殷师牛斗	殷師牛鬥
槠	櫧
槟	檳
槚	檟
槛	檻
钢梁	鋼樑
吊喭	弔喭
面包藏	面包藏
有只用	有只用
面食饭	面食飯
夏于乔	夏于喬
夸海口	誇海口
歌后	歌后
1余	1餘
采生折割	採生折割
卷来	捲來
面人儿	麵人兒
解铃仍须系铃人	解鈴仍須繫鈴人
大钟	大鐘
厮斗	廝鬥
信托	信託
少采	少採
自制下来	自制下來
曼谷	曼谷
向慕	嚮慕
于氏	于氏
斗富	鬥富
分别致	分别致
蚬	蜆
威士顿康星	威斯康辛
峻岭	峻岭
布谷鸟	布穀鳥
𧿈	𨇁
集里	集裡
生发油	生髮油
沈丹铁路	瀋丹鐵路
幸运胡	幸運鬍
桥梁	橋樑
太后	太后
上签	上籤
舌干唇焦	舌乾唇焦
种师中	种師中
心系输	心繫輸
之八九只	之八九只
聊斋志异	聊齋志異
烫个发	燙個髮
于秀敏	于秀敏
个中翘楚	箇中翹楚
数码照相机	數位照相機
丑吒	醜吒
4字节	4位元組
智能手机	智慧型手機
丑三	丑三
委托	委託
謝杰	謝杰
游行	遊行
鉴谅	鑑諒
荷里活	好萊塢
颤	顫
浚州	濬州
游街	遊街
通鉴	通鑑
直冲	直衝
鼻梁儿	鼻梁兒
自制她	自制她
痳疯	痳瘋
维系	維繫
连发式	連發式
大折儿	大摺兒
么叔	么叔
㭏	椲
划着獨木舟	划着獨木舟
天地为范	天地為範
𧒭	𧔥
上梁	上樑
金沙萨	金夏沙
屋梁	屋樑
后髮星系團	后髮星系團
對着幹	對着幹
夸称	誇稱
𬕂	篢
于斯纳尔斯贝里	于斯納爾斯貝里
㭤	樢
㭣	𣙎
多只需	多只需
叠席	疊蓆
几淨窗明	几淨窗明
窃钟掩耳	竊鐘掩耳
㭴	樫
啮齿类	嚙齒類
里边	裡邊
漠里	漠裡
谷禄	穀祿
仆人	僕人
干瞪眼	乾瞪眼
烤煙	烤菸
对不准	對不準
秀发表	秀發表
相克制	相克制
甜水面	甜水麵
老么	老么
宴游	宴遊
荦确	犖确
沙地阿拉伯	沙烏地阿拉伯
采桑	採桑
于泽尔	于澤爾
干笑	乾笑
径寄	逕寄
古钟表	古鐘錶
𩏼	䪏
𩏽	𩏪
𩏾	𩎢
𩏿	䪘
旋回	旋迴
寡欲	寡慾
藓	蘚
上签收	上簽收
顛顛仆仆	顛顛仆仆
几几	几几
于堅	于堅
几凳	几凳
定制	定製
手表	手錶
松化	鬆化
几出	幾齣
電子煙	電子菸
于雙戈	于雙戈
奸污	姦污
怜	憐
一出剧	一齣劇
只身子	只身子
𢀖	巠
怄	慪
怆	愴
态	態
怀	懷
怃	憮
怂	慫
干刻版	乾刻版
后海湾	后海灣
画里	畫裡
荧光	螢光
怿	懌
祝发	祝髮
总	總
后印	後印
長几	長几
8只支援	8只支援
地志	地誌
钟琴	鐘琴
夺斗	奪鬥
橥	櫫
条文里	條文裡
南京钟	南京鐘
九世之仇	九世之讎
于玉立	于玉立
羁系	羈繫
并发布	並發布
童仆	童僕
炼石	鍊石
吃里爬外	吃裡爬外
面皮	麵皮
荡产	蕩產
并发型模式	併發型模式
3周后	3周後
洗练	洗鍊
干洗	乾洗
尼克松	尼克森
强奸	強姦
荙	薘
荚	莢
蹦极跳	笨豬跳
荛	蕘
干下去	幹下去
干活	幹活
笋	筍
只身邊	只身邊
恒隆	恒隆
旱煙	旱菸
笃	篤
瑞城里	瑞城里
笔	筆
笕	筧
故云	故云
心系沈	心繫沈
五峰县	五峯縣
心系沙	心繫沙
并骨	併骨
笺	箋
笼	籠
笾	籩
挽车	輓車
交互设计	互動設計
黑山共和国	蒙特內哥羅共和國
5只	5隻
劫余	劫餘
峄	嶧
煙嘴	菸嘴
烬余	燼餘
困兽犹斗	困獸猶鬥
丙肝	C肝
音声如钟	音聲如鐘
发匪	髮匪
峦	巒
峥	崢
峤	嶠
峣	嶢
疯牛病	狂牛症
峡	峽
于衡	于衡
这出色	這出色
烧	燒
烦	煩
烩	燴
烨	燁
烫	燙
𥮜	䉲
热	熱
烬	燼
游侠	遊俠
素檀	蘇丹
未干	未乾
划到江心	划到江心
𥮋	𥸠
雇到	僱到
鸡丝	雞絲
烁	爍
只影響	只影響
烃	烴
烂	爛
拉面具	拉面具
国之桢干	國之楨榦
心系母	心繫母
烛	燭
那只怕	那只怕
烟	煙
征士	徵士
诚征	誠徵
安哈爾特	安哈特
丑丫头	醜丫頭
涂爾幹	涂爾幹
滨	濱
模范七棒	模范七棒
赞不绝口	讚不絕口
采取	採取
鬼谷子	鬼谷子
眼帘	眼帘
党家	党家
药	藥
苧麻	苧麻
夏历	夏曆
谢杰	謝杰
打断发	打斷發
荪	蓀
荫	蔭
怫郁	怫鬱
漓然	灕然
咸汤	鹹湯
弄干	弄乾
𬊤	燀
击扑	擊扑
双折射	雙折射
师范	師範
杜老志道	杜老誌道
提高后	提高後
刑余	刑餘
应征	應徵
姜是老的辣	薑是老的辣
广舍	廣捨
𬊈	燖
自制情	自制情
荣	榮
弄脏胸	弄髒胸
首出电影	首齣電影
车库里	車庫裡
不采声	不采聲
夸功	誇功
卷曲	捲曲
件钟	件鐘
嬉游	嬉遊
划桨	划槳
于澄	于澄
榴莲	榴槤
批复	批覆
采料	採料
沈吉	瀋吉
只眼	隻眼
𧹑	䞈
𧹓	𧶔
𧹕	䝻
𧹖	賟
𧹗	贃
托管	託管
堙淀	堙澱
百只够	百只夠
范亭	範亭
余三勝	余三勝
参数只	參數只
百只夠	百只夠
冤仇	冤讎
丑事	醜事
卷积云	捲積雲
煙袋	菸袋
華里沙	華勒沙
图里，	圖裡，
种師中	种師中
管干	管幹
缵	纘
朴念仁	樸念仁
6余	6餘
卤五花	滷五花
斗牛星	斗牛星
刘芸后	劉芸后
年历次	年歷次
煙灰	菸灰
须生	鬚生
弥弥	瀰瀰
干得	幹得
有只採	有只採
銮	鑾
謹愿	謹愿
于勒	于勒
0出，	0齣，
塞舌尔	塞席爾
凄厉	悽厲
網球台	網球台
只身后	只身後
张乐于张徐	張樂于張徐
儒略历	儒略曆
禁煙	禁菸
叶叶琴	葉叶琴
拼斗	拼鬥
谷梁	穀梁
大周后	大周后
落腮胡	落腮鬍
冷面殺手	冷面殺手
钢之炼金术师	鋼之鍊金術師
悲郁	悲鬱
維爾京群島	維京群島
韶山冲	韶山沖
别拗	彆拗
烤烟	烤菸
干热	乾熱
如饥似渴	如饑似渴
辔	轡
施罗德	施洛德
制盐	製鹽
1只支持	1只支持
黄金表	黃金表
塑料袋	塑膠袋
机械系	機械系
辙	轍
老仆	老僕
于小彤	于小彤
2字节	2位元組
楼	樓
横冲	橫衝
图	圖
吃面	吃麵
下签名	下簽名
剃须	剃鬚
獨聯體	獨立國協
二极管	二極體
胃里	胃裡
回绕	迴繞
艰	艱
最多	最多
一干部下	一干部下
艺	藝
但云	但云
漓水	灕水
辅	輔
复韵	複韻
复音	複音
勤朴	勤樸
围	圍
4只支持	4只支持
機床	工具機
煙具	菸具
心系她	心繫她
征验	徵驗
游猎	遊獵
心系奥	心繫奧
喽	嘍
喾	嚳
只身上有	只身上有
傅里叶	傅立葉
喷	噴
余人	餘人
辊	輥
喂	餵
照相干片	照相乾片
谚	諺
汤滷	汤滷
苦里	苦裡
生发水	生髮水
机械钟	機械鐘
一树百获	一樹百穫
困乏	睏乏
7只	7隻
凶疑	兇疑
藤制	藤製
数只需	數只需
座钟	座鐘
沈丹客运	瀋丹客運
天后半	天後半
紧致	緊緻
儉确之教	儉确之教
络腮胡	絡腮鬍
关系列	關系列
心系日	心繫日
于震环	于震環
足球台	足球台
团	團
語有云	語有云
旧游	舊遊
䌷	紬
百扎	百紮
挂面	掛麵
宁	寧
该钟	該鐘
儒略改革历史	儒略改革歷史
辟邪以律	闢邪以律
马里共和国	馬利共和國
䌻	䋚
严云农	嚴云農
公孙丑	公孫丑
䌺	䋙
染发	染髮
宝	寶
实	實
宠	寵
审	審
多只有	多只有
小只需	小只需
繁复	繁複
多只會	多只會
宪	憲
宫	宮
晶體管	電晶體
斗鹌鹑	鬥鵪鶉
宽	寬
宾	賓
箓	籙
于晨楠	于晨楠
旱烟	旱菸
整风后	整風後
咸鱼	鹹魚
斫雕为朴	斫雕為樸
包豪斯	包浩斯
简	簡
仲裁制	仲裁制
8只	8隻
忙里	忙裡
梁上	樑上
厄利垂亚	厄利垂亞
卷瓣	捲瓣
悬挂	懸掛
𫠜	齯
𫠆	頍
箦	簀
箧	篋
箪	簞
箫	簫
箨	籜
箩	籮
𫠊	䮄
心系民	心繫民
華倫西亞	瓦倫西亞
希伯来历	希伯來曆
移动设备	行動裝置
真个	真箇
系上红	繫上紅
𡭬	𡮣
西維爾	塞維亞
这只不过	這只不過
钟口	鐘口
轻松松	輕鬆鬆
乌苏里	烏蘇里
回文序列	迴文序列
赞扬	讚揚
干着急	干著急
幽并	幽并
桌历史	桌歷史
胜鍵	胜鍵
谒	謁
干警	幹警
烟袋	菸袋
朦胧	朦朧
鼻梁	鼻樑
移动支付	行動支付
巧干	巧幹
合准	合準
模制	模製
厄立特里亞	厄利垂亞
于树洁	于樹潔
厄立特里亚	厄利垂亞
并州	并州
殿里	殿裡
尸祿	尸祿
批准	批准
伊达里子	伊達里子
味美思	苦艾酒
金沙薩	金夏沙
征辟	徵辟
吐哺握发	吐哺握髮
卡斯特罗	卡斯楚
划艇	划艇
仆婢	僕婢
茶几	茶几
𤩽	瓛
征求	徵求
签押	籤押
尸祝	尸祝
须根据	須根據
发屋	髮屋
评注	評註
于靖	于靖
口里	口裡
余庆	餘慶
自制伏	自制伏
有栖川	有栖川
矮几	矮几
干花	乾花
月面	月面
荡平	蕩平
雪窗螢几	雪窗螢几
苍发	蒼髮
网志	網誌
榴蓮	榴槤
自制力	自制力
郁挹	鬱挹
回递性	迴遞性
之鉴	之鑑
制取	製取
争奇斗妍	爭奇鬥妍
龙须面	龍鬚麵
斗战	鬥戰
冷面笑匠	冷面笑匠
命中注定	命中注定
谕	諭
不干胶	不乾膠
型范	型範
干父之蛊	幹父之蠱
博茨瓦納	波札那
余烈	餘烈
萨拉热窝	塞拉耶佛
侯賽因	海珊
净发	淨髮
余烬	餘燼
余热	餘熱
批注	批註
盗采	盜採
冲坚陷阵	衝堅陷陣
包扎	包紮
魇	魘
魉	魎
于禁	于禁
谨愿	謹愿
径自	逕自
心系林	心繫林
准的	準的
丰神	丰神
数只有	數只有
冲天	沖天
心系乔	心繫喬
壶里	壺裡
媭	嬃
金表达	金表達
划不來	划不來
姜桂	薑桂
咸卤	鹹鹵
黄历	黃曆
只身形	只身形
阴郁	陰鬱
台钟	台鐘
被系上	被繫上
只身影	只身影
辰溪县	辰谿縣
被发佯狂	被髮佯狂
波斯尼亞和黑塞哥維那	波士尼亞與赫塞哥維納
妆台	妝檯
划子	划子
𫟅	綡
丑语	醜語
呂后	呂后
鈎	鉤
钟敲	鐘敲
干式	乾式
担担面	擔擔麵
𫟦	䡵
丑诋	醜詆
干弟	乾弟
𫟼	鐽
𫟹	鉷
𫟷	鉝
丑话	醜話
一斗斗	一斗斗
𩠠	𩠴
斯洛文尼亞	斯洛維尼亞
斯洛文尼亚	斯洛維尼亞
托名	託名
铁制	鐵製
征信	徵信
聖佐治	聖喬治
𩠅	𩟐
讠	訁
𩠇	䭀
𩠆	𩜦
𩠁	𩚵
𩠀	𩚥
𩠃	𩛩
𩠂	𩛆
让	讓
𩠌	餸
里海大學	里海大學
𩠎	𩞄
𩠉	𩜇
𩠈	䭃
𩠋	𩝔
议	議
讱	訒
记	記
讳	諱
讲	講
里海大学	里海大學
讴	謳
讷	訥
讶	訝
讹	訛
甲型肝炎	A型肝炎
讻	訩
论	論
讽	諷
讼	訟
访	訪
设	設
凶案	兇案
淀积	澱積
属	屬
脚注	腳註
屉	屜
届	屆
杠轂	杠轂
屃	屓
层	層
个中强手	箇中強手
屿	嶼
干旱	乾旱
逍遥游	逍遙遊
于幼军	于幼軍
切尔诺贝利	車諾比
屡	屢
绑紧跳	笨豬跳
屦	屨
于从濂	于從濂
勃朗宁	白朗寧
獭	獺
游伴	遊伴
千只怕	千只怕
手表態	手表態
赞叹	讚嘆
髋	髖
风后	風后
窑	窯
𥬀	䉙
明征	明徵
䭪	𩞯
坐钟	坐鐘
棉里	棉裡
𥬠	篘
夸饰	誇飾
仙后	仙后
睐	睞
对着干	對着幹
癸丑	癸丑
唢	嗩
唠	嘮
唡	啢
唤	喚
哈囉喂	哈囉喂
发已霜白	髮已霜白
说不准	說不準
准则	準則
脉冲	脈衝
余七	餘七
土里	土裡
唛	嘜
吁天	籲天
余三	餘三
唝	嗊
电脑程序	電腦程式
校准	校準
生发液	生髮液
余业	餘業
䲝	䱽
䲟	鮣
䲞	𩶘
准分子	準分子
达芬奇	達文西
系恋	繫戀
巅	巔
七情六欲	七情六慾
格魯吉亞	喬治亞
心系故	心繫故
米团	米糰
火并非	火並非
汤卤	汤滷
云然	云然
，并力讨	，并力討
絷	縶
手松	手鬆
干爹	乾爹
干爸	乾爸
䲣	䱷
䲢	鰧
干爽	乾爽
䲤	鿐
佳里鎮	佳里鎮
团子	糰子
秀发动	秀發動
胎发	胎髮
臧谷亡羊	臧穀亡羊
几杖	几杖
女丑	女丑
会干扰	會干擾
冲线	衝線
戴表元	戴表元
庆历史	慶歷史
夸姣	誇姣
苏昆	蘇崑
闺范	閨範
瞎蒙	瞎矇
开发	開發
浚县	濬縣
年鉴	年鑑
扎伊尔	薩伊
垱	壋
稳扎	穩紮
圖盧茲	土魯斯
马耳他	馬爾他
征文	徵文
丑地	醜地
龙斗虎伤	龍鬥虎傷
杰倫	杰倫
划了一會	划了一會
因特网	網際網路
一划	一划
划得来	划得來
佛罗棱萨	佛羅稜薩
借由	藉由
这只包括	這只包括
准保釋	准保釋
好斗大	好斗大
重托	重託
本·拉登	賓·拉登
两个	兩個
𦈠	䌥
𦈡	繻
科斗	科斗
六楼后座	六樓后座
𦈚	縬
𦈛	繓
𦈘	䌋
𦈙	䌰
𦈞	䌟
𦈟	䌝
𦈜	䌖
𦈝	繏
𦈒	𦂅
𦈓	䋿
𦈐	縺
𦈑	緸
𦈖	䌈
𦈗	𦃄
𦈔	縎
𦈕	緰
𦈋	綇
𦈈	𥿊
𦈉	緷
𦈎	繟
𦈏	緍
𦈌	綀
雨蒙蒙	雨濛濛
阵	陣
没准	沒準
腾冲	騰衝
谳	讞
面坯儿	麵坯兒
宝历史	寶歷史
于友澤	于友澤
沙特阿拉伯	沙烏地阿拉伯
艾奧瓦	愛荷華
陶制	陶製
安哈尔特	安哈特
扎成	紮成
愿而恭	愿而恭
撇吊	撇弔
意大利	義大利
系上，	繫上，
丑夷	醜夷
懿范	懿範
并发症	併發症
划动	划動
阁	閣
第比利斯	提比里西
巧历史	巧歷史
贪欲	貪慾
炼制	煉製
阇	闍
头发	頭髮
赏赞	賞讚
西游	西遊
不托	不託
躯干	軀幹
老爷钟	老爺鐘
𣗋	欓
四分历	四分曆
石钟	石鐘
队	隊
阿聯酋	阿聯
苋	莧
苈	藶
苎	苧
苏	蘇
苌	萇
苍	蒼
苁	蓯
科摩罗	葛摩
响钟	響鐘
半只	半隻
春游	春遊
佣鈿	佣鈿
𪎌	麳
采药	採藥
于斯達爾	于斯達爾
𪎍	𪋿
苧	薴
母范	母範
愠	慍
飏	颺
风	風
愦	憒
歹斗	歹鬥
张勋	張勳
一干弟子	一干弟子
飚	飈
飙	飆
飘	飄
飞	飛
飓	颶
飒	颯
飑	颮
飐	颭
飗	飀
飖	颻
飕	颼
飔	颸
软驱	軟碟機
飨	饗
喧哄	喧鬨
干红葡萄酒	乾紅葡萄酒
余温	餘溫
南回线	南迴線
缩栗	縮慄
夸嘴	誇嘴
小周后	小周后
心系麦	心繫麥
里间	裡間
𣲗	湋
架钟	架鐘
只身心	只身心
𣲘	潕
5只支持	5只支持
文思泉涌	文思泉湧
魂牵梦系	魂牽夢繫
烟熏	煙燻
结伙	結夥
哥特式	哥德式
制纸	製紙
空蒙	空濛
心系他	心繫他
空气质量	空氣品質
航海历	航海曆
械斗	械鬥
水里商工	水里商工
一争两丑	一爭兩醜
警报钟	警報鐘
并购	併購
封面里	封面裡
烤卤	烤滷
4杆	4桿
采摘	採摘
干渠	乾渠
泳气钟	泳氣鐘
垂发	垂髮
五天后	五天後
旧钟表	舊鐘錶
于榮光	于榮光
佛钟	佛鐘
框里	框裡
干渴	乾渴
嬷	嬤
大历	大曆
𫢸	僤
盈余	盈餘
稆	穭
8余	8餘
税	稅
䗖	螮
稳	穩
𩟿	𩚛
丑男	醜男
𥇢	䁪
昔人有云	昔人有云
余威德	余威德
皮制	皮製
䢀	𨊰
反覆	反覆
叠	疊
系累	繫纍
号	號
叶	葉
涳蒙	涳濛
叹	嘆
绾发	綰髮
叽	嘰
揭丑	揭醜
拆伙	拆夥
参	參
叁	叄
干撂台	乾撂台
叇	靆
叆	靉
当且仅当	若且唯若
放松	放鬆
郁沉沉	鬱沉沉
无烟日	無菸日
复习	複習
双	雙
发	發
叙	敘
变	變
呆里呆气	呆裡呆氣
乙肝	B肝
丑女效颦	醜女效顰
肚里	肚裡
淀淀	澱澱
䯃	𩣑
回纹针	迴紋針
䯄	騧
䯅	䯀
同伙	同夥
特制	特製
珰	璫
珲	琿
天后天	天後天
數碼化	數位化
珑	瓏
珐	琺
郁抑	鬱抑
伊尔汗历表	伊爾汗曆表
谠	讜
万象	萬象
仑	侖
巴厘岛	峇里島
滚	滾
余式	餘式
全干	全乾
局促不安	局促不安
集数里	集數裡
削发	削髮
显示表达	顯示表達
曲櫱	麴櫱
傻里傻气	傻裡傻氣
余弦	餘弦
斗技	鬥技
7周后	7周後
复利	複利
于晴	于晴
复制	複製
哈啰喂	哈囉喂
鉴湖	鑑湖
莜面	莜麵
厘订	釐訂
会干	會幹
咸海	鹹海
心里	心裡
栖	棲
净余	淨餘
么小	么小
声母后	聲母後
元凶	元兇
特制定	特制定
夸辩	誇辯
丑年	丑年
煎面	煎麵
雅穆苏克雷	雅穆索戈
赵治勋	趙治勳
蟻后	蟻后
受雇	受僱
斯堪的納維亞	斯堪地那維亞
电脑网络	電腦網路
恒基	恒基
田庄英雄	田庄英雄
點煙	點菸
垭	埡
罗马历代	羅馬歷代
收获	收穫
夸奖	誇獎
𡶴	嵼
并入	併入
钟不	鐘不
钟上	鐘上
钟下	鐘下
并兼	併兼
夸她	誇她
托言	託言
一余	一餘
弗吉尼亚	維吉尼亞
日志	日誌
伯明翰	伯明罕
心里面	心裏面
简并	簡併
芯片	晶片
凄然	悽然
吃里扒外	吃裡扒外
体系	體系
美发业	美髮業
夸父	夸父
佣仆	傭僕
栌	櫨
〇只	〇隻
虚拟现实	虛擬實境
整出剧	整齣劇
9杆	9桿
栈	棧
范例	範例
栊	櫳
加蓬	加彭
范登堡	范登堡
宇航服	太空衣
晶体管	電晶體
两扎	兩紮
自制	自製
冲击	衝擊
冲出	衝出
于志宁	于志寧
金钟	金鐘
挽联	輓聯
脊梁	脊樑
以自制	以自制
西西里	西西里
窗明几净	窗明几淨
𫁡	鴗
谷贵饿农	穀貴餓農
国仇	國讎
伊府面	伊府麵
郁郁而终	鬱鬱而終
满	滿
太仆	太僕
面制品	麵製品
胡子	鬍子
0出电影	0齣電影
里士满	里奇蒙
准绳	準繩
苹婆	蘋婆
七个	七個
于會泳	于會泳
杠梁	杠梁
威爾士	威爾斯
鼗	鞀
称赞	稱讚
冲心	衝心
桂圆干	桂圓乾
于伟国	于偉國
代数里	代數裡
祭吊	祭弔
颊须	頰鬚
橱	櫥
参数里	參數裡
那只限	那只限
算准	算準
发簪	髮簪
橹	櫓
橼	櫞
𪎊	麨
道范	道範
煙絲	菸絲
荜	蓽
荝	萴
荞	蕎
荟	薈
心系非	心繫非
回翔	迴翔
栗冽	慄冽
这出人	這出人
荐	薦
逼并	逼併
松劲	鬆勁
松动	鬆動
争斗	爭鬥
荆	荊
吧台	吧檯
复分数	複分數
巡回医疗	巡回醫療
張樂于張徐	張樂于張徐
挂名	掛名
冲去	衝去
荬	蕒
荭	葒
荮	葤
钟的	鐘的
荨	蕁
荩	藎
高峰时段	尖峰時段
余僇	餘僇
荤	葷
荥	滎
荦	犖
荧	熒
荠	薺
荡	盪
肉面	肉麵
天文钟	天文鐘
于湘蘭	于湘蘭
上台面	上檯面
棱柱	稜柱
于斯納爾斯貝里	于斯納爾斯貝里
纸扎	紙紮
尽先	儘先
簸荡	簸蕩
6字节	6位元組
𤾀	皟
鼍	鼉
后母戊	后母戊
心系贫	心繫貧
咝	噝
咙	嚨
咛	嚀
私下里	私下裡
舍去	捨去
征状	徵狀
8字节	8位元組
马萨诸塞	麻薩諸塞
余杰	余杰
铜钟	銅鐘
分多钟	分多鐘
余杭	餘杭
䌶	䊷
余杯	餘杯
龜山庄	龜山庄
表速	錶速
䌹	絅
干脆面	乾脆麵
䌿	䋹
䌾	䋻
䌽	綵
䌼	綐
炼字	鍊字
罗马历史	羅馬歷史
折梯	摺梯
克罗地亚	克羅埃西亞
心系曼	心繫曼
椰枣干	椰棗乾
塞尔维亚和黑山	塞爾維亞與蒙特內哥羅
锤炼	錘鍊
多只是	多只是
只身	隻身
欲念	慾念
隐占	隱佔
浮罗交怡	蘭卡威
人物志	人物誌
香山庄	香山庄
洒然	洒然
媪	媼
里海	裏海
餐台	餐檯
于天仁	于天仁
划不来	划不來
窜	竄
酒坛	酒罈
毁钟为铎	毀鐘為鐸
老撾人民民主共和國	寮人民民主共和國
余量	餘量
窎	窵
𥅘	𥌃
窍	竅
中签了	中簽了
沈大铁路	瀋大鐵路
窃	竊
风干	風乾
数字音乐	數位音樂
窝里斗	窩裡鬥
骢	驄
窭	窶
左冲右突	左衝右突
窦	竇
窥	窺
凉面	涼麵
𥅴	䀹
吃板刀面	吃板刀麵
多天后	多天後
彭于晏	彭于晏
时钟	時鐘
筑后	筑後
旁征博引	旁徵博引
介胄	介冑
征庸	徵庸
于都縣	于都縣
有征	有徵
干细胞	幹細胞
咸嘴淡舌	鹹嘴淡舌
許愿起經	許愿起經
干衣	乾衣
抗御	抗禦
挤	擠
系上安全	繫上安全
划走	划走
斗劲	鬥勁
划起	划起
触摸屏	觸控螢幕
于慧	于慧
于幼軍	于幼軍
怎么干	怎麼幹
乡愿	鄉愿
干鱼	乾魚
骚	騷
斗力	鬥力
汇丰	滙豐
吊脚儿事	弔腳兒事
健力士世界紀錄	金氏世界紀錄
博杰普尔	博杰普爾
霉黑	黴黑
8天后	8天後
面包抄	面包抄
骟	騸
霉黧	黴黧
上签定	上簽定
卤的	滷的
帕劳	帛琉
揪须	揪鬚
煙酒	菸酒
平准	平準
如果干	如果幹
三出戏	三齣戲
钟乳石	鐘乳石
老撾	寮國
骄	驕
鉴藏	鑑藏
垦辟	墾闢
参绥	蔘綏
毛里求斯	模里西斯
百子里	百子里
姜丝	薑絲
智能手機	智慧型手機
徒杠	徒杠
䴖	鶄
另辟	另闢
萦回	縈迴
的干将	的幹將
发漂	髮漂
数据库	資料庫
面摊	麵攤
骏	駿
四天后	四天後
卷儿	捲兒
撺	攛
抢	搶
抡	掄
抠	摳
0天后	0天後
钟行	鐘行
报	報
护	護
余生	餘生
自制之能	自制之能
数只是	數只是
骨坛	骨罈
塞爾維亞與蒙特內哥羅	塞爾維亞與蒙特內哥羅
渊淳岳峙	淵淳嶽峙
口干涉	口干涉
表板	錶板
并发模式	併發模式
其八九只	其八九只
抛	拋
顼	頊
顿	頓
于若木	于若木
抟	摶
顸	頇
须	須
顺	順
页	頁
顷	頃
顶	頂
拉面无	拉面無
干啥	幹啥
𩨍	𩥇
耕获	耕穫
采访	採訪
愈合	癒合
铁托	狄托
尸利	尸利
干啼	乾啼
丑脸	醜臉
征用	徵用
于凤桐	于鳳桐
才干	才幹
葡萄干	葡萄乾
擀面	擀麵
借助	藉助
钟表	鐘錶
伊斯蘭堡	伊斯蘭瑪巴德
乐器钟	樂器鐘
武后	武后
咸的	鹹的
系里	系裡
錾	鏨
韫	韞
三藩市	舊金山
沟	溝
韪	韙
沣	灃
顽	頑
没	沒
沧	滄
沦	淪
沥	瀝
抚	撫
沪	滬
沩	溈
沨	渢
游兴	遊興
新奧爾良	紐奧良
冲克	衝剋
五个	五個
顾	顧
藏历	藏曆
杆菌	桿菌
韦	韋
满头洋发	滿頭洋髮
项	項
示范	示範
袅	裊
袄	襖
岳麓	嶽麓
袆	褘
采薇	採薇
朴素	樸素
袜	襪
尽量	儘量
袭	襲
后土	后土
袯	襏
采薪	採薪
不只	不只
谷保家商	穀保家商
脏腑	臟腑
归余	歸餘
丁丑	丁丑
准保護	准保護
7杆	7桿
坑口里	坑口里
心系地	心繫地
卤	鹵
卧	臥
卢	盧
卫	衛
却	卻
酿制	釀製
丰韻	丰韻
心系在	心繫在
大丑	大醜
丰韵	丰韻
鸣钟	鳴鐘
𫮃	墠
奥巴马	歐巴馬
咸淡	鹹淡
协	協
华	華
云何	云何
一碗面	一碗麵
单	單
卖	賣
拉面	拉麵
几面上	几面上
钟表面	鐘表面
于來山	于來山
牵	牽
照入签	照入籤
划龍舟	划龍舟
牺	犧
厘革	釐革
牦	氂
松松地	鬆鬆地
炼冶	鍊冶
潜水表	潛水錶
划龍船	划龍船
洪钟	洪鐘
冬冬鼓	鼕鼕鼓
幸幸	倖幸
牍	牘
电子烟	電子菸
皇历	皇曆
护发展	護發展
手塚治虫	手塚治虫
回复中	回覆中
马拉维	馬拉威
吴	吳
多只限	多只限
启	啟
听	聽
强制	強制
吨	噸
吣	唚
模范棒棒堂	模范棒棒堂
吗	嗎
吕	呂
系船	繫船
吓	嚇
后	後
翕辟	翕闢
凶悍	兇悍
首当其冲	首當其衝
员	員
䎬	䎱
钟螺	鐘螺
松紧	鬆緊
出丑	出醜
籁	籟
于赠	于贈
家仆	家僕
呜	嗚
干电	乾電
揮手表	揮手表
干田	乾田
天历	天曆
抽公签	抽公籤
准儿	準兒
发鬓	髮鬢
类	類
心系晓	心繫曉
呓	囈
准三后	准三后
呒	嘸
候复	候覆
采录	採錄
开采	開採
鉴识	鑑識
涩谷区	澀谷區
禁烟	禁菸
冲程	衝程
凯瑟琳	凱薩琳
征令	徵令
单单于	單單於
干支剌	乾支剌
京沈	京瀋
划槳	划槳
里氏4	芮氏4
里氏5	芮氏5
里氏6	芮氏6
里氏7	芮氏7
里氏0	芮氏0
里氏1	芮氏1
里氏2	芮氏2
里氏3	芮氏3
瓮安	甕安
徵狀	症狀
发状况	發狀況
里氏8	芮氏8
里氏9	芮氏9
𬸣	鶱
𬸦	鷟
寶山庄	寶山庄
𬸪	鷭
胡渣	鬍渣
国历代	國歷代
扛大梁	扛大樑
停征	停徵
心系父	心繫父
计算机程序	電腦程式
尸羅	尸羅
賦范	賦范
𬸘	鶠
𬸚	鸑
圣文森特和格林纳丁斯	聖文森及格瑞那丁
于思	于思
府干犯	府干犯
于娟	于娟
于娜	于娜
大型钟表面	大型鐘表面
干裂	乾裂
未干预	未干預
个中玄机	箇中玄機
征引	徵引
闲邪	閑邪
萌島	曼島
不占卜	不占卜
逞凶斗狠	逞兇鬥狠
咸菜	鹹菜
征调	徵調
凄美	悽美
游必有方	遊必有方
能干预	能干預
𬜯	䓣
毕	畢
折痕	摺痕
划去	划去
毙	斃
优游	優遊
关系所	關系所
复色	複色
毁	毀
毂	轂
辛丑	辛丑
毵	毿
复眼	複眼
卡塔爾	卡達
几内亚比绍	幾內亞比索
毡	氈
夸他	誇他
镰仓	鎌倉
吊撒	弔撒
宪法里	憲法裡
四杆铁笔	四桿鐵筆
于天龙	于天龍
余兴	餘興
余八	餘八
叱咤	叱吒
鉴往知来	鑑往知來
余六	餘六
于广洲	于廣洲
蝎谮	蝎譖
于天龍	于天龍
余党	餘黨
这出世	這出世
钟没	鐘沒
沤	漚
旅游	旅遊
半制品	半制品
余光	餘光
几只	幾隻
范文藤	范文藤
戬	戩
戯	戱
冲垮	衝垮
哗笑	譁笑
干哥	乾哥
痒疹	痒疹
干哭	乾哭
后面店	後面店
九扎	九紮
复议	複議
干篾片	乾篾片
四面包	四面包
卤鹅	滷鵝
戏	戲
戋	戔
应钟	應鐘
戆	戇
看准	看準
战	戰
干柴烈火	乾柴烈火
干哕	乾噦
戗	戧
猛冲	猛衝
𨱏	鎝
𨱎	鍮
𨱍	鎯
𨱌	鏆
𨱋	錂
𨱊	𨧱
𨱉	鍄
𨱈	鋉
𨱇	銶
𨱆	龯
𨱅	鉁
𨱄	鈯
𨱃	鈲
𨱂	鈋
𨱁	鈠
𨱀	𨥛
网里	網裡
𨱖	䥩
多出电影	多齣電影
𨱔	鐏
𨱓	鐎
𨱒	鏉
𨱑	鐄
𨱐	𨫒
𣶩	澅
准例	準例
𣶫	𣿉
注译	註譯
腌制	醃製
衬里	襯裡
流荡	流蕩
梁柱	樑柱
个中道理	箇中道理
发廊	髮廊
密致	密緻
当准	當準
娆	嬈
娇	嬌
路签	路籤
娅	婭
干漆	乾漆
冲陷	衝陷
草丛里	草叢裡
代码表	代碼表
娴	嫻
拳局	拳跼
娱	娛
松耦合	鬆耦合
辟为	闢為
蒙瞍	矇瞍
无征不信	無徵不信
奸情	姦情
鼠曲草	鼠麴草
领袖欲	領袖慾
𪨗	屩
电子钟	電子鐘
香干	香乾
淳朴	淳樸
电	電
蛎	蠣
画	畫
𪨊	㞞
蜂准	蜂準
𪨶	輋
不嫌母丑	不嫌母醜
䓖	藭
亿个	億個
回复邮件	回覆郵件
冲要	衝要
很丑	很醜
伙头	伙頭
于克-兰多县	于克-蘭多縣
凭闲	憑閑
刮起来	刮起來
咸湖	鹹湖
台静农	臺靜農
移动电话	行動電話
多只须	多只須
勋	勛
门吊儿	門弔兒
撞阵冲军	撞陣衝軍
墙里	牆裡
咸湿	鹹濕
角抵	角牴
勚	勩
口干预	口干預
干糇	乾餱
5只支援	5只支援
狱	獄
狰	猙
狲	猻
风土志	風土誌
叶利钦	葉爾欽
狭	狹
独	獨
狯	獪
狮	獅
婵	嬋
丑沮	醜沮
洋河大曲	洋河大麯
疲困	疲睏
狝	獮
大历史	大歷史
松手	鬆手
烟品	菸品
松通	鬆通
金表面	金表面
刮了	颳了
狈	狽
数字照相机	數位照相機
特拉華	德拉瓦
栗栖溪	栗栖溪
干系	干係
戴发含齿	戴髮含齒
轉向	轉向
闻风后	聞風後
壮游	壯遊
德累斯頓	德勒斯登
鉴别	鑑別
杜塞爾多夫	杜塞道夫
干耗	乾耗
悠荡	悠蕩
赤绳系足	赤繩繫足
斗文	鬥文
于楓	于楓
秒表示	秒表示
解铃还须系铃人	解鈴還須繫鈴人
心系英	心繫英
绞干	絞乾
钟发音	鐘發音
僵尸	殭屍
心系病	心繫病
斗引	鬥引
博茨瓦纳	波札那
回文联	迴文聯
额征	額徵
沙里淘金	沙裡淘金
住扎	住紮
斗地主	鬥地主
里脊	裡脊
几旁	几旁
暴敛横征	暴斂橫徵
大型钟	大型鐘
暗地里	暗地裡
宦游	宦遊
冲突	衝突
牵系	牽繫
递回	遞迴
更钟爱	更鍾愛
巡游	巡遊
么九	么九
口干	口乾
瑙魯	諾魯
只字	隻字
姜糖	薑糖
刻钟	刻鐘
鸡争鹅斗	雞爭鵝鬥
战栗	戰慄
捉奸细	捉奸細
昆腔	崑腔
鲸须	鯨鬚
于欣源	于欣源
湖里	湖裡
真凶	真兇
𬺈	齮
被发阳狂	被髮陽狂
月历	月曆
𬺓	齼
霉素	黴素
氇	氌
那只有	那只有
邬	鄔
获	獲
邮	郵
监制	監製
5字节	5位元組
邺	鄴
余四	餘四
恶斗	惡鬥
子之丰兮	子之丰兮
霍爾木茲	荷姆茲
场里	場裡
布里斯托尔	布里斯托
长发公主	長髮公主
只身旁	只身旁
氢	氫
金仆姑	金僕姑
藏蒙歌儿	藏矇歌兒
氩	氬
艾森豪威尔	艾森豪
高后	高后
不食乾腊	不食乾腊
游民	遊民
邝	鄺
氲	氳
佳肴	佳肴
七只	七隻
𢭏	擣
邓	鄧
余荫	餘蔭
吊膀子	弔膀子
黑奴吁天录	黑奴籲天錄
褛	褸
奇勋	奇勳
积淀	積澱
干礼	乾禮
闹表	鬧錶
霉菌	黴菌
褴	襤
采用	採用
吊扣	弔扣
埃及历	埃及曆
不卷	不捲
湮郁	湮鬱
细不容发	細不容髮
息交绝游	息交絕遊
𣍰	脥
八扎	八紮
𣍨	𦢈
腰里	腰裡
于子千	于子千
𣍯	腪
歼	殲
复苏	復甦
麦	麥
所托	所託
发笺	髮箋
于家堡	于家堡
于道泉	于道泉
中文里	中文裡
麸	麩
麹	麴
断发文身	斷髮文身
聩	聵
聪	聰
余1	餘1
这出生	這出生
余6	餘6
翻松	翻鬆
准决赛	準決賽
知識產權	智慧財產權
聋	聾
职	職
聍	聹
从山里	從山裡
聂	聶
仆程	僕程
政斗	政鬥
6只支持	6只支持
于澤爾	于澤爾
联	聯
陈杰	陳杰
淀谓之滓	澱謂之滓
万周后	萬周後
中签发	中簽發
昙	曇
拓朴	拓樸
斗法会	斗法會
蕴	蘊
鼓里	鼓裡
攻打	攻打
面包庇	面包庇
抽烟	抽菸
回肠	迴腸
刿	劌
轮回	輪迴
丙型肝炎	C型肝炎
冲车	衝車
𨸇	𨵸
糁	糝
几净窗明	几淨窗明
糇	餱
饥馑	饑饉
，并力討	，并力討
斗眼	鬥眼
凶相毕露	凶相畢露
心系彼	心繫彼
模范	模範
伊東怜	伊東怜
干疥	乾疥
𬟁	虉
蒜发	蒜髮
妈	媽
网球台	網球台
基里巴斯	吉里巴斯
妆	妝
妇	婦
数只会	數只會
发干	發乾
葉陽后	葉陽后
皮松	皮鬆
傲游	傲遊
太初历史	太初歷史
妩	嫵
妪	嫗
妫	媯
颠颠仆仆	顛顛仆仆
婢仆	婢僕
𬟽	蝀
冲量	衝量
差之毫厘	差之毫厘
吊影	弔影
疮	瘡
疯	瘋
疬	癧
疭	瘲
疠	癘
疡	瘍
心系港	心繫港
疱	皰
戴卓爾	柴契爾
闲荡	閒蕩
重复	重複
网络游戏	網路遊戲
珍寶客機	巨無霸客機
柏林牆	柏林圍牆
纪历史	紀歷史
荡妇	蕩婦
银发	銀髮
聖盧西亞	聖露西亞
疟	瘧
胡子婴	胡子嬰
凤凰于飞	鳳凰于飛
疖	癤
疗	療
斗牙拌齿	鬥牙拌齒
脱发	脫髮
贵干	貴幹
衅钟	釁鐘
鳥栖市	鳥栖市
金表扬	金表揚
威尔士	威爾斯
采在	採在
于凌奎	于凌奎
征得	徵得
农民历史	農民歷史
鸡吵鹅斗	雞吵鵝鬥
泾	涇
𠆲	儣
回旋加速	回旋加速
划過	划過
余论	餘論
𠆿	𠌥
义仆	義僕
并日而食	并日而食
数字电视	數位電視
腾格里	騰格里
伊于湖底	伊于湖底
未干預	未干預
㧰	擽
索马里兰	索馬利蘭
牙签	牙籤
盗钟	盜鐘
煙蒂	菸蒂
㧏	掆
捏面人	捏麵人
大型钟表	大型鐘錶
零个	零個
㧟	擓
㧑	撝
㧐	㩳
其二只	其二只
月里来	月裡來
对表明	對表明
理个发	理個髮
𡝠	㜷
威斯特法伦	威斯伐倫
塞耳盗钟	塞耳盜鐘
干股	乾股
面包涵	面包涵
干肥	乾肥
雇车	僱車
尽早	儘早
于小惠	于小惠
里衣	裡衣
借手	藉手
澄江县	澂江縣
烟蒂	菸蒂
斯蒂芬	史蒂芬
余墨	餘墨
乙丑	乙丑
炼汞	鍊汞
系舟	繫舟
跹	躚
西周钟	西周鐘
棱台	稜台
没样范	沒樣範
太凶	太兇
有恒街	有恒街
于敏中	于敏中
张柏芝	張栢芝
钟形虫	鐘形蟲
朴陋	樸陋
准时	準時
赞比亚	尚比亞
回复：	回覆：
掷	擲
掴	摑
掳	擄
掼	摜
私斗	私鬥
掺	摻
掸	撣
鹿場里	鹿場里
強制	強制
饹	餎
饸	餄
饻	餏
饺	餃
饽	餑
饼	餅
饿	餓
饾	餖
饱	飽
饰	飾
饳	飿
饲	飼
饵	餌
饴	飴
饷	餉
饶	饒
松浮	鬆浮
饨	飩
饫	飫
饪	飪
饭	飯
饬	飭
饯	餞
饮	飲
干呕	乾嘔
饣	飠
丛林里	叢林裡
饥	飢
一目了然	一目了然
饧	餳
饦	飥
機械人	機器人
蹑	躡
蹒	蹣
忌廉	奶油
柳诒征	柳詒徵
吊者大悦	弔者大悅
䴙	鷿
准会	準會
蹰	躕
勋章	勳章
东盟	東協
采区	採區
蹿	躥
格林納丁斯	格瑞那丁
逻	邏
𫇭	蔿
涂	塗
党項	党項
后里	后里
涟	漣
桢	楨
涝	澇
逦	邐
电影后	電影後
踊	踴
𢫬	摋
递	遞
屏风后	屏風後
涩	澀
涨	漲
涧	澗
桦	樺
丑角	丑角
涤	滌
涣	渙
涢	溳
涡	渦
涠	潿
适	適
桤	榿
逊	遜
𢫊	𢷮
桥	橋
不采聲	不采聲
松一口气	鬆一口氣
佛历	佛曆
枢	樞
冥蒙	冥濛
蝎蝎螫螫	蝎蝎螫螫
诗赞	詩讚
于枫	于楓
𨐈	輄
𨐉	𨎮
𨐊	𨏥
𨐅	軗
𨐆	𨊻
𨐇	𨏠
往日无仇	往日無讎
余蓄	餘蓄
趙惠后	趙惠后
出游	出遊
吊拷	弔拷
十出生	十出生
剩余	剩餘
没干没净	沒乾沒淨
干柴	乾柴
剥	剝
于克-蘭多縣	于克-蘭多縣
剧	劇
于丹	于丹
局里	局裡
剑	劍
剐	剮
尸羅精舍	尸羅精舍
庄内地方	庄內地方
剀	剴
剂	劑
拉面上	拉面上
性别扭曲	性別扭曲
复信	覆信
云乎	云乎
航天飞机	太空梭
南游	南遊
国历史	國歷史
吕后	呂后
悠悠荡荡	悠悠蕩蕩
䥺	釾
中岳	中嶽
䥾	䥱
䥿	𨯅
钟左右	鐘左右
采石之战	采石之戰
不來梅	不萊梅
广播里	廣播裡
于風政	于風政
封為后	封為后
于国治	于國治
心系嘱	心繫囑
胡云	胡云
进两出	進兩出
四出征收	四出徵收
碑志	碑誌
上梁山	上梁山
一半只	一半只
知识产权局	知識產權局
扎带子	紮帶子
卷地	捲地
这只在	這只在
9天后	9天後
只言片语	隻言片語
抽煙	抽菸
红后假说	紅后假說
邻	鄰
罚	罰
1杆	1桿
于冠華	于冠華
网	網
历局	曆局
罗	羅
果干	果乾
折椅	摺椅
罂	罌
们干的	們幹的
缓冲	緩衝
二杆	二桿
罴	羆
冲过	衝過
罢	罷
澒蒙	澒濛
跄	蹌
行事历史	行事歷史
筑前	筑前
鳘	鰵
郁结	鬱結
配图里	配圖裡
鳞	鱗
木钟	木鐘
台风	颱風
强制作用	強制作用
籼	秈
和奸	和姦
复次	複次
制得	製得
反反复复	反反覆覆
血余	血餘
烘制	烘製
千周后	千周後
菜肴	菜餚
鳕	鱈
上面糊	上面糊
反朴	反樸
钵	缽
帕塔亚	芭達亞
遇风后	遇風後
朴鄙	樸鄙
𬤝	譓
昆剧	崑劇
薝卜	薝蔔
甩发	甩髮
互聯網	網際網路
〇周后	〇周後
王田里	王田里
𬤇	諲
局域网络	區域網路
钩心斗角	鈎心鬥角
咸食	鹹食
麻酱面	麻醬麵
𬤊	諟
头发展	頭發展
游走	遊走
坦荡	坦蕩
摩根士丹利	摩根史坦利
瘘	瘺
悒郁	悒鬱
鳃	鰓
丰台	豐臺
堡子里	堡子里
含齿戴发	含齒戴髮
鉴证	鑑證
游资	遊資
蒙特利爾	蒙特婁
于振	于振
火山里	火山裡
余割	餘割
征购	徵購
于根伟	于根偉
丰滨	豐濱
乃系	乃係
後庄	後庄
莱特湾	雷伊泰灣
饭后钟	飯後鐘
梦里	夢裡
斗倒	鬥倒
划进	划進
溲面	溲麵
钟关	鐘關
郁黑	鬱黑
捣鬼吊白	搗鬼弔白
详注	詳註
划过	划過
谷皮	穀皮
太阁	太閤
棱镜	稜鏡
格林纳达	格瑞那達
啰啰苏苏	囉囉囌囌
鸟	鳥
多只在	多只在
卤菜	滷菜
二缶钟惑	二缶鐘惑
鸪	鴣
鸫	鶇
鸨	鴇
他干的	他幹的
鸮	鴞
鸯	鴦
云：	云：
鸭	鴨
鸢	鳶
鸣	鳴
鸠	鳩
鸡	雞
鸦	鴉
鸧	鶬
鸤	鳲
鸥	鷗
鸺	鵂
鸻	鴴
鸸	鴯
鸹	鴰
鸾	鸞
十余	十餘
鸼	鵃
鸽	鴿
鸲	鴝
鸳	鴛
鸰	鴒
鸱	鴟
鸶	鷥
鸷	鷙
鸴	鷽
鸵	鴕
小只是	小只是
驾	駕
胶	膠
竹林之游	竹林之遊
争红斗紫	爭紅鬥紫
防制法	防制法
大批涌到	大批湧到
雇佣	僱傭
子里甲	子里甲
关系着	關係著
胧	朧
贊比亞	尚比亞
五行生克	五行生剋
胫	脛
胨	腖
驺	騶
吊文	弔文
美丑	美醜
清心寡欲	清心寡欲
丑末	醜末
胶卷	膠捲
胜	勝
胀	脹
胁	脅
胆	膽
邋里邋遢	邋裡邋遢
干号	乾號
雠	讎
复核	覆核
雳	靂
松蛋	鬆蛋
挡	擋
挠	撓
挣	掙
挢	撟
挥	揮
驯	馴
挦	撏
挛	攣
挚	摯
挝	撾
挜	掗
挟	挾
挞	撻
胡朴安	胡樸安
雏	雛
编钟	編鐘
徒托空言	徒託空言
夸来夸去	誇來誇去
余气	餘氣
挂	掛
心系澳	心繫澳
本傑明	班傑明
浮夸	浮誇
大只能	大只能
四面钟	四面鐘
于偉國	于偉國
试制	試製
朴直	樸直
卷走	捲走
卷起	捲起
刚雇	剛僱
应用程序	應用程式
交游	交遊
九只	九隻
熏黑	燻黑
独联体	獨立國協
井干	井幹
𬙂	縯
卤水	滷水
干急	乾急
干性	乾性
𬙋	纕
𬙊	纆
千回百折	千迴百折
余思敏	余思敏
4只	4隻
导弹	飛彈
磁制	磁製
头	頭
相克	相剋
夺	奪
波发藻	波髮藻
夹	夾
备	備
处	處
滃郁	滃鬱
中签定	中簽定
个钟表	個鐘錶
复	復
獨立國家聯合體	獨立國家國協
盐打怎么咸	鹽打怎麼鹹
卧游	臥遊
够	夠
桌游	桌遊
八字胡	八字鬍
琼	瓊
赈饥	賑饑
手表明	手表明
卤肉	滷肉
拧	擰
琎	璡
琏	璉
前往	前往
苦干	苦幹
干打雷	乾打雷
那只比	那只比
喂了一声	喂了一聲
理发动	理發動
琐	瑣
击	擊
零只	零隻
7天后	7天後
行人路	人行道
丑毙了	醜斃了
看法里	看法裡
创获	創穫
奸淫	姦淫
咸潟	鹹潟
手表現	手表現
凫	鳧
干杯	乾杯
凭	憑
警世钟	警世鐘
几	幾
汉弥登钟	漢彌登鐘
凤	鳳
凛	凜
于于	于于
凑	湊
干材	乾材
凉	涼
减	減
百余	百餘
净	淨
凄	淒
斲雕为朴	斲雕為樸
瘫	癱
爱困	愛睏
于尔根	于爾根
馂余	餕餘
𪉑	鷔
𪉐	𪃍
𪉓	𪈼
𪉒	𪄕
𪉕	𪇳
痒痒	痒痒
波棱菜	波稜菜
仅余	僅餘
械系	械繫
缠斗	纏鬥
𪉃	鳼
𪉂	䲰
𪉅	𪀦
𪉄	𩿪
𪉆	鴲
𪉉	𪁈
𪉈	鴜
𪉋	𪀾
𪉊	鷨
𪉍	鵚
𪉌	𪁖
𪉏	𪃏
𪉎	𪂆
人干的	人幹的
卷款	捲款
多丑	多醜
多只可	多只可
纲鉴	綱鑑
余外	餘外
复变函数	複變函數
复合	複合
发网菌	髮網菌
菠萝干	菠蘿乾
舒卷	舒捲
百周后	百周後
百只足夠	百只足夠
于遠偉	于遠偉
游荡	遊蕩
筑州	筑州
唾面自干	唾面自乾
托了	託了
托事	託事
東盟	東協
干脆	乾脆
咸菜干	鹹菜乾
沈山线	瀋山線
圣马力诺	聖馬利諾
文翠珊	德蕾莎·梅伊
修杰楷	修杰楷
𧮪	詀
发为血之本	髮為血之本
涂壮勋	涂壯勳
望了望	望了望
干肉片	乾肉片
自制地	自制地
荡气回肠	盪氣迴腸
累囚	纍囚
盼复	盼覆
卤了	滷了
咪表	咪錶
辟谷	辟穀
余光中	余光中
杰威爾	杰威爾
法自制	法自制
林鹅峰	林鵞峰
游记	遊記
爱	愛
水里	水裡
图卢兹	土魯斯
披榛采兰	披榛採蘭
圆珠笔	原子筆
舊庄	舊庄
迈凯轮	麥拿輪
于再清	于再清
煙頭	菸頭
力争上游	力爭上遊
征怪	徵怪
塞维利亚	塞維亞
言大而夸	言大而夸
𩧦	𩡺
謝華后	謝華后
并为一家	併為一家
伊斯兰历史	伊斯蘭歷史
组里	組裡
镉	鎘
洒	灑
于尔岑	于爾岑
殘奧會	帕運會
只身高	只身高
外强中干	外強中乾
镍	鎳
桢干	楨幹
只身體	只身體
带发修行	帶髮修行
0字节	0位元組
长历史	長歷史
无烟环境	無菸環境
谷谷	穀穀
洼	窪
陳士杰	陳士杰
回文锦	迴文錦
安沈铁路	安瀋鐵路
下签发	下簽發
丑行	醜行
镄	鐨
复选	複選
宽松	寬鬆
9余	9餘
𩾋	䱰
𩾊	䱬
𩾈	䱙
蘖	櫱
官历	官曆
𩾌	鱇
𩾃	鮸
𩾂	䲖
𩾁	鯄
𩾇	鯱
𩾆	𩸦
𩾅	𩸃
𩾄	𩷰
龌	齷
马恩岛	曼島
龈	齦
龉	齬
龊	齪
龋	齲
龄	齡
龅	齙
龆	齠
龇	齜
龀	齔
龁	齕
龂	齗
龃	齟
镑	鎊
龟	龜
龙	龍
龚	龔
龛	龕
制毒	製毒
摊	攤
沈淀	沈澱
摈	擯
乒乓球	桌球
海淀山后	海淀山後
摆	擺
摇	搖
摄	攝
摅	攄
荡气	蕩氣
镩	鑹
渖	瀋
干白葡萄酒	乾白葡萄酒
腼	靦
腽	膃
腾	騰
于韦斯屈莱	于韋斯屈萊
腻	膩
兆个	兆個
采金	採金
露丑	露醜
下签订	下簽訂
腭	齶
心系长	心繫長
志喜	誌喜
扎实	紮實
陳冲	陳冲
𫍣	詷
腌	醃
印累绶若	印纍綬若
镣	鐐
腊	臘
托故	託故
腊笔	腊筆
心脏	心臟
孟德爾遜	孟德爾頌
岱岳	岱嶽
爱德华州	愛達荷州
智能機械人	智慧機器人
八个	八個
詟	讋
𤶧	𤸫
典范	典範
8周后	8周後
碧咸	貝克漢
祝赞	祝讚
梁启超	梁啓超
之征	之徵
𫍯	諴
翙	翽
翘	翹
翚	翬
𢬦	𢹿
联系	聯繫
一出好戏	一齣好戲
心系广	心繫廣
并发表	並發表
心系幼	心繫幼
髭胡	髭鬍
吊头	弔頭
修杰麟	修杰麟
上签证	上簽證
只冲	只衝
镵	鑱
·范	·范
素面	素麵
钟停	鐘停
䥽	鏺
蛏干	蟶乾
恢复	恢復
杠人	杠人
里层	裡層
里屋	裡屋
虚夸	虛誇
蒙事	矇事
凄惶	悽惶
数字技术	數位技術
五岳	五嶽
慌里慌张	慌裡慌張
征答	徵答
不占算	不占算
墙	牆
藏历史	藏歷史
𪢮	圞
不好干涉	不好干涉
廍子里	廍子里
扎紧	紮緊
7只支援	7只支援
天后来	天後來
扼肮	搤肮
表蒙子	錶蒙子
克死	剋死
年历史	年歷史
璎	瓔
劉佳怜	劉佳怜
于风政	于風政
月历史	月歷史
，并力	，並力
余勇	餘勇
种师道	种師道
叩钟	叩鐘
洞里薩	洞里薩
府干擾	府干擾
挌斗	挌鬥
𩙰	𩙈
2杆	2桿
余貾	餘貾
浓发	濃髮
刮起	颳起
刮走	颳走
答复	答覆
贝尔格莱德	貝爾格勒
𩙦	𩗀
𩙧	𩗡
𩙥	颰
𩙪	颷
𩙫	颾
𩙨	𩘹
丰南	丰南
𩙮	䬘
𩙯	䬝
𩙬	𩘺
𩙭	𩘝
泶	澩
台风后	颱風後
千钧一发	千鈞一髮
面包管	面包管
丑媳	醜媳
植发	植髮
仆役	僕役
郑	鄭
郐	鄶
复元音	複元音
毕加索	畢卡索
好斗室	好斗室
㻘	𤪺
溟蒙	溟濛
陪吊	陪弔
㻏	𤫩
写保护	防寫
馏	餾
嘯咤	嘯吒
往里	往裡
里勾外连	裡勾外連
干完	幹完
岡比亞	甘比亞
于台烟	于台煙
郁气	鬱氣
昵称	暱稱
面馆	麵館
搭干铺	搭乾鋪
余妙	餘妙
开征	開徵
里面	裡面
制品	製品
防水表	防水錶
𫭼	𡑍
干家	幹家
车站里	車站裡
宜云	宜云
老姜	老薑
勾魂荡魄	勾魂蕩魄
于振武	于振武
干锅	乾鍋
陧	隉
挽词	輓詞
官不怕大只怕管	官不怕大只怕管
闲情逸致	閒情逸緻
种放	种放
险	險
余沥	餘瀝
黄干黑瘦	黃乾黑瘦
干卦	乾卦
局域网	區域網
挽诗	輓詩
青霉	青黴
干阿奶	乾阿奶
际	際
裁并	裁併
陆	陸
水来汤里去	水來湯裡去
搬斗	搬鬥
陉	陘
陈	陳
合采	合採
陕	陝
厂部	厂部
干酵母	乾酵母
冲下	衝下
冲上	衝上
里应外合	裡應外合
黄曲毒素	黃麴毒素
于都县	于都縣
斗草	鬥草
转	轉
轭	軛
轮	輪
软	軟
轨	軌
轩	軒
落車	下車
轫	軔
车	車
轧	軋
径入	逕入
轼	軾
大蜡	大蜡
轾	輊
轿	轎
轸	軫
轹	轢
轺	軺
轻	輕
轴	軸
轵	軹
轶	軼
轷	軤
轰	轟
轱	軲
轲	軻
轳	轤
陈升	陳昇
威廉姆斯	威廉士
仿制	仿製
丰情	丰情
鲚	鱭
酒帘	酒帘
浅	淺
溃	潰
双折	雙摺
府干政	府干政
溇	漊
溆	漵
溅	濺
在制品	在制品
鲞	鯗
膵脏	膵臟
竹签	竹籤
科特迪瓦	象牙海岸
當勞·特朗普	唐納·川普
意大利面	意大利麵
得到回复	得到回覆
向往常	向往常
凄酸	悽酸
勋爵	勳爵
准确	準確
瓦努阿圖	萬那杜
痳痹	痳痺
埃及历史	埃及歷史
鲕	鮞
采油	採油
鲖	鮦
实干	實幹
鲈	鱸
蚁	蟻
蚀	蝕
蚃	蠁
蚂	螞
绑扎	綁紮
蚕	蠶
干尸	乾屍
新庄子	新庄子
黄白术	黃白術
兽	獸
鞭辟入里	鞭辟入裡
花哄	花鬨
兹	茲
鲎	鱟
养	養
兴	興
千只能	千只能
兰	蘭
关	關
注明	註明
雾里	霧裡
鲀	魨
游标卡尺	遊標卡尺
鼠标	滑鼠
谢华后	謝華后
纽黑文	紐哈芬
党	黨
兖	兗
兑	兌
铝制	鋁製
墨斗	墨斗
发型	髮型
空余	空餘
鲇	鯰
于品海	于品海
心系唐	心繫唐
太空飛行員	太空人
鲺	鯴
营干	營幹
流征	流徵
不食干腊	不食乾腊
余响	餘響
松饼	鬆餅
互聯網絡	網際網路
多只須	多只須
仆从	僕從
卵与石斗	卵與石鬥
余额	餘額
黄岩县	黃巖縣
回佣	回佣
星期后	星期後
澹台	澹臺
多只能	多只能
游憩	遊憩
菜干	菜乾
鲵	鯢
哄动	鬨動
学家	學家
鲷	鯛
于尔里克	于爾里克
大金发苔	大金髮苔
好斗胆	好斗膽
更钟	更鐘
多只比	多只比
发妻	髮妻
鲫	鯽
琴钟	琴鐘
石杠	石杠
鲭	鯖
荧郁	熒鬱
得克萨斯	德克薩斯
鲯	鯕
于大宝	于大寶
境里	境裡
路面	路面
车里	車裡
鲢	鰱
准式	準式
磨面	磨麵
么鳳	么鳳
鲦	鰷
𫵷	㠣
心系川	心繫川
荡船	蕩船
了若指掌	瞭若指掌
采好	採好
于远伟	于遠偉
垂范	垂範
秀发村	秀發村
荡舟	蕩舟
五扎	五紮
郁积	鬱積
谷氨	穀氨
颠干倒坤	顛乾倒坤
程序员	程式設計師
饥荒	饑荒
塞爾維亞和黑山	塞爾維亞與蒙特內哥羅
新奥尔良	紐奧良
筑西	筑西
1周后	1周後
筝	箏
昆苏	崑蘇
蒙骗	矇騙
斗法	鬥法
双胜类	雙胜類
涂羽卿	涂羽卿
臣仆	臣僕
9字节	9位元組
森林里	森林裡
摸钟	摸鐘
股栗	股慄
余十	餘十
明鉴	明鑑
曹子里	曹子里
衡鉴	衡鑑
抱素怀朴	抱素懷樸
卤煮	滷煮
洞里萨	洞里薩
算历史	算歷史
白发其事	白發其事
风里	風裡
郁郁菲菲	郁郁菲菲
采摭	採摭
油面	油麵
吁请	籲請
干纲	乾綱
嫌凶	嫌兇
夸诞	誇誕
金表情	金表情
桌几	桌几
公历	公曆
夸说	誇說
舍己为人	捨己為人
沾益	霑益
是发小	是髮小
阳历	陽曆
简筑翎	簡筑翎
钟表停	鐘錶停
台历史	台歷史
打谷	打穀
夸诩	誇詡
幾內亞比紹	幾內亞比索
天神之后	天神之后
金表现	金表現
旧	舊
无	無
制鞋	製鞋
一地里	一地裡
旸	暘
3只支援	3只支援
时	時
希拉克略	希拉克略
激斗	激鬥
鼋	黿
鸡奸	雞姦
丑时	丑時
鼹	鼴
内罗毕	奈洛比
丑旦	丑旦
丑日	丑日
㛣	㜏
毛坏	毛坏
高几	高几
𩧱	𩥉
下签定	下簽定
臜	臢
细致	細緻
打钟	打鐘
𤇄	熌
東湖里	東湖里
本出戏	本齣戲
鉴察	鑑察
小只有	小只有
于山国	于山國
材干	材幹
潮涌	潮湧
囱	囪
朴实	樸實
韬	韜
借以	藉以
笔秃墨干	筆禿墨乾
韩	韓
韨	韍
韧	韌
扼肮拊背	搤肮拊背
界里	界裡
钟面	鐘面
韵	韻
私欲	私慾
嘴里	嘴裡
谞	諝
扯面	扯麵
郁塞	鬱塞
丑表功	丑表功
扑咚咚	撲鼕鼕
萧参	蕭蔘
饥渴	饑渴
辫发	辮髮
古文里	古文裡
哀吊	哀弔
施舍	施捨
斗胜	鬥勝
运	運
维系统	維系統
连	連
迟	遲
远	遠
违	違
进	進
还	還
这	這
过	過
系上头	繫上頭
国历任	國歷任
迁	遷
发披肩	髮披肩
灰蒙	灰濛
迈	邁
迳	逕
殷鉴	殷鑑
斗私批修	鬥私批修
迹	跡
𨉗	軉
惨淡	慘澹
诗云	詩云
两鼠斗穴	兩鼠鬥穴
索马里	索馬里
阿塞拜疆	亞塞拜然
伊適杰	伊適杰
迩	邇
金圣叹	金聖歎
赫鲁晓夫	赫魯雪夫
干甚么	幹甚麼
繫着	繫着
调	調
官地为采	官地為寀
男仆	男僕
仇隙	讎隙
松弛	鬆弛
郭后	郭后
松元音	鬆元音
心细如发	心細如髮
于小偉	于小偉
冷面相	冷面相
舍短取长	捨短取長
涌水	湧水
𧉞	䗿
堕	墮
遗范	遺範
堑	塹
丝发	絲髮
白朴	白樸
博杰普爾	博杰普爾
二手烟	二手菸
于仁泰	于仁泰
馬利蘭	馬里蘭
眬	矓
折戟沈河	折戟沈河
白术	白朮
墨子里	墨子里
灘涂	灘涂
眦	眥
标致	標緻
夏于喬	夏于喬
鹮	䴉
共和历	共和曆
功勋	功勳
眍	瞘
谲	譎
心系台	心繫台
干生受	乾生受
推托	推託
谶	讖
飘游	飄遊
圈里	圈裡
伡	俥
谵	譫
苦斗	苦鬥
存盘	存檔
𨱕	𨮂
㘎	㘚
松脆	鬆脆
機械系	機械系
谷胱	穀胱
个中原因	箇中原因
舍命	捨命
锆	鋯
松开	鬆開
卷入	捲入
只身材	只身材
发油	髮油
冉有仆	冉有僕
食欲	食慾
历本	曆本
斗狗	鬥狗
干不成	幹不成
干结	乾結
心系和	心繫和
河里	河裡
挂钩	掛鈎
干练	幹練
贾后	賈后
世纪钟	世紀鐘
干绷	乾繃
谦	謙
公历史	公歷史
斗狠	鬥狠
削面	削麵
刮风后	颳風後
3天后	3天後
于宝轩	于寶軒
瘋牛症	狂牛症
绪	緒
游艇	遊艇
杂面	雜麵
谷日	穀日
谷旦	穀旦
绯	緋
游艺	遊藝
绮	綺
于台煙	于台煙
性欲	性慾
浮松	浮鬆
注解	註解
單鏡反光機	單眼相機
控件	控制項
坐台鐵	坐台鐵
注册	註冊
穆罕默德历史	穆罕默德歷史
卡塔尔	卡達
浑个	渾箇
快闪存储器	快閃記憶體
山崩钟应	山崩鐘應
钟头	鐘頭
钟太	鐘太
尽管	儘管
局躅	跼躅
西历次	西歷次
’m	’m
么弟	么弟
’t	’t
绺	綹
’s	’s
丰容	丰容
于斯达尔	于斯達爾
折子	摺子
掌柜	掌柜
汇算	彙算
数只应	數只應
繁钟	繁鐘
喂了一聲	喂了一聲
郁伊	鬱伊
𩲒	𩳤
哗嚣	譁囂
特制住	特制住
重游	重遊
禾谷	禾穀
操作钟	操作鐘
金表演	金表演
松脱	鬆脫
古钟	古鐘
锲而不舍	鍥而不捨
后冠	后冠
丑剌剌	醜剌剌
干灯盏	乾燈盞
飞刍挽粟	飛芻輓粟
3只	3隻
锻	鍛
莼	蓴
绉	縐
薙发	薙髮
沈郁	沈鬱
仆夫	僕夫
麦克尔	麥可
聖馬力諾	聖馬利諾
煙鬼	菸鬼
火签	火籤
野游	野遊
绌	絀
誉	譽
張杰	張杰
娄	婁
帝后台	帝后臺
赌斗	賭鬥
百只足够	百只足夠
誊	謄
干颡	乾顙
回复帖子	回覆帖子
𫍰	諰
𫍲	謏
谷茬	穀茬
渔	漁
渗	滲
重回	重回
渑	澠
𫍽	譞
渍	漬
渌	淥
𫍢	譊
渎	瀆
渊	淵
披头散发	披頭散髮
折纸	摺紙
熏烤	燻烤
𫍙	訑
棫朴	棫樸
温	溫
娈	孌
绝	絕
艸木丰丰	艸木丰丰
荷里活廣場	荷里活廣場
拮据	拮据
蜡	蠟
肠脏	腸臟
水里高級商工	水里高級商工
这出版	這出版
娲	媧
二虎相斗	二虎相鬥
真人騷	真人秀
采猎	採獵
绔	絝
髡发	髡髮
压制出	壓製出
绗	絎
蜗	蝸
蜕	蛻
拉面皮	拉面皮
捉奸贼	捉奸賊
荡漾	蕩漾
鲙	鱠
潜水钟表	潛水鐘錶
鲛	鮫
鲜	鮮
鲝	鮺
数	數
鲟	鱘
鲐	鮐
鲑	鮭
鲒	鮚
鲓	鮳
鬈发	鬈髮
藤席	藤蓆
萝卜干	蘿蔔乾
鲗	鰂
手表達	手表達
鲉	鮋
鲊	鮓
鲋	鮒
鲌	鮊
鲍	鮑
不列颠哥伦比亚省	卑詩省
鲏	鮍
惠文后	惠文后
鲁	魯
鲂	魴
鲃	䰾
鲄	魺
鲅	鮁
鲆	鮃
敩	斆
鲸	鯨
鲹	鰺
䀥	䁻
鲻	鯔
鱼干	魚乾
圭亚那	蓋亞那
鲾	鰏
鲿	鱨
鲰	鯫
鲱	鯡
鲲	鯤
鲳	鯧
鲴	鯝
敛	斂
没事干	沒事幹
鲨	鯊
鲩	鯇
鲪	鮶
编制法	編制法
鲬	鯒
冲起	衝起
鲮	鯪
排干部	排幹部
鲠	鯁
鲡	鱺
敌	敵
鲣	鰹
鲤	鯉
鲥	鰣
郁郁不乐	鬱鬱不樂
鲧	鯀
钟模	鐘模
发光可鉴	髮光可鑑
蝼	螻
淫欲	淫慾
订制	訂製
了結他	了結他
七余	七餘
范文	範文
关系科	關系科
秀发生	秀發生
细炼	細鍊
发面	發麵
0余	0餘
𫗧	餗
儒略历史	儒略歷史
柱梁	柱樑
鬒发	鬒髮
游山玩水	遊山玩水
舞台风格	舞台風格
发夹	髮夾
郘钟	郘鐘
捞面	撈麵
诗钟	詩鐘
大明历	大明曆
積架	捷豹
绩	績
绨	綈
绫	綾
克林頓	柯林頓
续	續
绬	緓
阿拉伯联合酋长国	阿拉伯聯合大公國
花马吊嘴	花馬弔嘴
绡	綃
绠	綆
绣	繡
绢	絹
绥	綏
绤	綌
继	繼
绦	絛
绹	綯
绸	綢
绻	綣
粗制	粗製
绽	綻
综	綜
绿	綠
绾	綰
绱	鞝
绰	綽
绳	繩
绲	緄
绵	綿
维	維
绷	繃
绶	綬
大干	大幹
终	終
绋	紼
绊	絆
绍	紹
蓝淀	藍澱
经	經
绎	繹
绁	紲
绀	紺
练	練
绂	紱
绅	紳
组	組
织	織
细	細
给	給
绘	繪
绛	絳
绚	絢
賢后	賢后
络	絡
统	統
绞	絞
绑	綁
绐	紿
结	結
绒	絨
绕	繞
网站里	網站裡
苹果	蘋果
绖	絰
𬇙	浿
标志	標誌
五谷王南街	五谷王南街
𬇕	澫
于慎行	于慎行
选手表决	選手表決
尼日爾	尼日
自然数里	自然數裡
筑肥	筑肥
𬇹	漍
徕	徠
干折	乾折
瞄准	瞄準
盲干	盲幹
亿天后	億天後
瑞征	瑞徵
径	徑
叱咤M	叱咤M
斗鸡	鬥雞
杯面	杯麵
斗鸭	鬥鴨
当当	噹噹
凄苦	悽苦
叱咤9	叱咤9
烟头	菸頭
冲杀	衝殺
抑郁	抑鬱
淀粉	澱粉
心系千	心繫千
吊谎	弔謊
心系十	心繫十
虾面	蝦麵
𥹥	𥼽
𪾢	睍
尸鸠	尸鳩
卷烟	捲菸
慈溪	慈谿
莱索托	賴索托
预报不准	預報不準
五谷王北街	五谷王北街
二手煙	二手菸
多只	多隻
缝制	縫製
尝	嘗
采过	採過
诖	詿
显示表现	顯示表現
采运	採運
叱咤咤	叱咤咤
卫星钟	衛星鐘
肉干	肉乾
于斌	于斌
船只有	船只有
肝脏	肝臟
公仔面	公仔麵
社里	社裡
征训	徵訓
數碼照相機	數位照相機
首只	首隻
叮当	叮噹
首发	首發
凄怆	悽愴
朴鲁	樸魯
伙伴	夥伴
划着船	划着船
正杰	正杰
字母后	字母後
快冲	快衝
重罗面	重羅麵
心系南	心繫南
一个准	一個準
不占凶吉	不占凶吉
董氏封发	董氏封髮
毫发	毫髮
于特森	于特森
伊适杰	伊適杰
回銮	迴鑾
赞许	讚許
隱私	隱私
借鉴	借鑑
心系百	心繫百
胜肽	胜肽
于耘婕	于耘婕
假托	假託
酒麹	酒麴
影相吊	影相弔
凶徒	兇徒
仆虽罢驽	僕雖罷駑
中型钟	中型鐘
凶征	凶徵
嫱	嬙
瞆	瞶
瞒	瞞
靥	靨
龙卷	龍捲
显示表面	顯示表面
阴历史	陰歷史
𫐆	轣
靓	靚
𫐄	軏
己丑	己丑
吉尼斯世界纪录	金氏世界紀錄
瞩	矚
𫐉	軨
乔戈里峰	K2
𫐓	輮
后羿	后羿
诜	詵
𫐐	輗
分子钟	分子鐘
公里海	公里海
几进几出	幾進幾出
点里程	點里程
肉松	肉鬆
谷贱伤农	穀賤傷農
几天后	幾天後
寓禁于征	寓禁於徵
撚须	撚鬚
欲壑难填	慾壑難填
𩨐	𩧆
𬭁	鉧
铁杆	鐵桿
扑撻	扑撻
豮	豶
噜苏	嚕囌
不斗	不鬥
𫛭	鵟
文杰	文杰
穿梭機	太空梭
好斗笠	好斗笠
谷米	穀米
斗来斗去	鬥來鬥去
拭干	拭乾
轮奸	輪姦
和制英语	和製英語
于化虎	于化虎
𫏋	蹻
澜	瀾
新罕布什尔	新罕布夏
拉面巾	拉面巾
公余	公餘
費米面	費米面
战天斗地	戰天鬥地
𫛛	鳷
㛠	𡢃
杂合面儿	雜合麵兒
𣘓	𣞻
螨	蟎
王后	王后
程十发	程十髮
缜致	縝緻
府干	府幹
余桃	餘桃
方法里	方法裡
凭几	憑几
𣘷	𣝕
螀	螿
孙杰	孫杰
𣘴	檭
么篇	么篇
云尔	云爾
停制	停製
連結他	連結他
教学钟	教學鐘
巴士拉	巴斯拉
伤	傷
可自制	可自制
面杖	麵杖
年历	年曆
并拢	併攏
老白干	老白乾
打出吊入	打出弔入
须根	鬚根
小时里	小時裡
荷里活道	荷里活道
八只	八隻
胃脏	胃臟
麟游	麟遊
㚯	㜄
面条	麵條
仆欧	僕歐
后平路	后平路
么蛾子	么蛾子
佣	傭
佥	僉
吊卷	弔卷
有棱有角	有稜有角
体	體
偬	傯
幸免	倖免
涂天相	涂天相
斗牌	鬥牌
于里察	于里察
党怀英	党懷英
偿	償
偾	僨
佈	布
斗牛	鬥牛
大夸	大誇
凭借	憑藉
姜还是老的辣	薑還是老的辣
储	儲
打印机	印表機
伞	傘
蜂涌	蜂湧
𬬭	錀
𬬮	鋹
𬬩	釴
余众	餘眾
貴价	貴价
滩	灘
𬬿	鉊
𬬸	鉥
𬬹	鉮
𬬻	鑪
余羡	餘羨
𬬱	釿
板荡	板蕩
昊天不吊	昊天不弔
里通外国	裡通外國
准不准	準不準
干瘾	乾癮
祢	禰
废后	廢后
部子里	部子里
死里逃生	死裡逃生
桃金娘	桃金孃
利欲	利慾
干瘪	乾癟
祯	禎
砻谷	礱穀
晾干	晾乾
武斗	武鬥
狞	獰
祃	禡
磁道	磁軌
鳥栖	鳥栖
祎	禕
整出戏	整齣戲
个中好手	箇中好手
油斗	油鬥
干茶钱	乾茶錢
钱范	錢範
简朴	簡樸
丰仪	丰儀
唱游	唱遊
于根偉	于根偉
并叠	併疊
于浩威	于浩威
棱体	稜體
凄怨	悽怨
2只支援	2只支援
泸州大曲	瀘州大麯
锻炼	鍛鍊
磨炼	磨鍊
冲掉	衝掉
多周后	多周後
仆妇	僕婦
揿	撳
张杰	張杰
岁聿云暮	歲聿云暮
只身世	只身世
墨沈沈	墨沈沈
托孤	託孤
游学	遊學
十周后	十周後
粘膜	黏膜
咸咸	鹹鹹
卤牛	滷牛
见素抱朴	見素抱樸
稻谷	稻穀
忙里偷闲	忙裡偷閒
湿	濕
十出	十齣
这出道	這出道
后瑞站	后瑞站
云敞	云敞
干过	幹過
朝乾夕惕	朝乾夕惕
下文里	下文裡
干部	幹部
干这	幹這
扎好底子	扎好底子
萝卜	蘿蔔
夸丽	誇麗
敲钟	敲鐘
范本	範本
嘘	噓
中断发	中斷發
黎吉云	黎吉雲
涂長望	涂長望
心系慈	心繫慈
分半钟	分半鐘
𢛯	㦎
划着竹筏	划着竹筏
表转	錶轉
不每只	不每只
能干戈	能干戈
精制	精製
懞懞懂懂	懞懞懂懂
𫷷	廞
划来划去	划來划去
发禁	髮禁
松缓	鬆緩
智能電話	智慧型電話
丰标	丰標
咸鸭蛋	鹹鴨蛋
辟划	闢劃
留发行	留發行
喂！	喂！
大赞	大讚
喂，	喂，
开山辟谷	開山闢谷
后髮FK型星	后髮FK型星
袋表	袋錶
姜酮	薑酮
改采	改採
6只	6隻
戈尔巴乔夫	戈巴契夫
计时表	計時錶
谬赞	謬讚
阴沟里翻船	陰溝裡翻船
斗斗	鬥鬥
采纳	採納
果累累	果纍纍
查韦斯	查維茲
铻	鋙
铺	鋪
铹	鐒
铸	鑄
铿	鏗
链	鏈
五周后	五周後
铼	錸
铳	銃
铲	鏟
铱	銥
铰	鉸
铷	銣
银	銀
铵	銨
铴	鐋
铫	銚
铪	鉿
铩	鎩
铨	銓
铯	銫
铮	錚
铭	銘
铬	鉻
铣	銑
铢	銖
铡	鍘
铠	鎧
铧	鏵
铦	銛
铥	銩
铤	鋌
铛	鐺
铚	銍
铙	鐃
铘	鋣
铟	銦
铞	銱
铝	鋁
铜	銅
铓	鋩
铒	鉺
铑	銠
铐	銬
铗	鋏
铖	鋮
生发药	生髮藥
铔	錏
铋	鉍
铊	鉈
铉	鉉
下签约	下簽約
铏	鉶
铎	鐸
铍	鈹
铌	鈮
铃	鈴
铂	鉑
铁	鐵
瘿	癭
铇	鉋
铆	鉚
于明濤	于明濤
铄	鑠
煙民	菸民
纥	紇
惇朴	惇樸
干凉	乾涼
滩席	灘蓆
沈抚	瀋撫
冲力	衝力
干净	乾淨
纣	紂
沈大线	瀋大線
䶮	龑
么爸	么爸
何杰	何杰
么爺	么爺
北仑河	北崙河
唯一只	唯一只
冲劲	衝勁
淡蒙蒙	淡濛濛
线	線
茶面	茶麵
高干预	高干預
才干涉	才干涉
世界杯	世界盃
巴尔干	巴爾幹
心系摩	心繫摩
冲动	衝動
强	強
前波美拉尼亚	前波莫瑞
弹	彈
前波美拉尼亞	前波莫瑞
炼金术	鍊金術
舍己为公	捨己為公
弪	弳
吊贺迎送	弔賀迎送
弯	彎
浮羅交怡	蘭卡威
气冲斗牛	氣沖斗牛
张	張
内脏	內臟
㱩	殰
數據庫	資料庫
㱮	殨
卷叶蛾	捲葉蛾
弑	弒
异	異
弃	棄
开	開
台面上	檯面上
蝎虎	蝎虎
付托	付託
野姜	野薑
顶凶	頂兇
一扎	一紮
郊游	郊遊
心系募	心繫募
航海历史	航海歷史
望后石	望后石
食面	食麵
御侮	禦侮
周后	周后
格林纳丁斯	格瑞那丁
陳有后	陳有后
紫姜	紫薑
像赞	像讚
八天后	八天後
射雕	射鵰
加泰罗尼亚	加泰隆尼亞
域里	域裡
丑剧	醜劇
凝炼	凝鍊
干燥	乾燥
心系宣	心繫宣
埙	塤
埘	塒
吊古	弔古
俪	儷
俫	倈
俨	儼
合伙人	合伙人
俭	儉
俣	俁
心系家	心繫家
有发头陀寺	有髮頭陀寺
西历任	西歷任
芒果干	芒果乾
都市里	都市裡
心系它	心繫它
数字钟表	數字鐘錶
悬梁	懸樑
西历代	西歷代
鄭凱云	鄭凱云
胡杰	胡杰
后台老板	後台老板
克剥	剋剝
升高后	升高後
涂敏恆	涂敏恆
须鲸	鬚鯨
脱谷机	脫穀機
整只	整隻
就范	就範
涂敏恒	涂敏恆
只身受	只身受
商历史	商歷史
欲障	慾障
人欲	人慾
剥制	剝製
秋千	鞦韆
卷轴	捲軸
万个	萬個
并力	併力
折冲	折衝
暗里	暗裡
𡋀	𡓾
云游	雲遊
远游	遠遊
位准	位準
蓊郁	蓊鬱
千只足夠	千只足夠
𡋗	𡑭
六余	六餘
欢	歡
千只足够	千只足夠
泄欲	洩慾
斗暴	鬥暴
这出	這齣
采伐	採伐
历数书	曆數書
仆僮	僕僮
旧历史	舊歷史
山梁	山樑
賈后	賈后
谷圭	穀圭
李連杰	李連杰
乾象历	乾象曆
大衍历	大衍曆
相并	相併
相干	相干
长发姑娘	長髮姑娘
寒栗	寒慄
拿准	拿準
開普勒	克卜勒
制浆	製漿
累臣	纍臣
丝发生	絲發生
奏折	奏摺
普利策	普利茲
尸鳩	尸鳩
冲撞	衝撞
惊赞	驚讚
征友	徵友
征发	徵發
颛顼历	顓頊曆
合历	合曆
干馆	乾館
征召	徵召
灵昆	靈崑
干馏	乾餾
乔布斯	賈伯斯
范式	範式
纤夫	縴夫
溫納圖萬	那杜
于江震	于江震
干个	幹個
谷舱	穀艙
余思	餘思
一锅面	一鍋麵
鹅准	鵝準
漤	灠
十只	十隻
匏系	匏繫
不加自制	不加自制
特征	特徵
干上	幹上
公仆	公僕
岫岩	岫巖
过水面	過水麵
干丝	乾絲
厄瓜多尔	厄瓜多
钟鼓	鐘鼓
钟鼎	鐘鼎
吊慰	弔慰
萨	薩
新扎	新紮
萧	蕭
萦	縈
营	營
萤	螢
萚	蘀
理发现	理發現
游客	遊客
萝	蘿
炼形	鍊形
局促	侷促
几率	機率
转向	轉向
余步	餘步
结伴同游	結伴同遊
鹁	鵓
涂紹煃	涂紹煃
于軍	于軍
一厘一毫	一釐一毫
点多钟	點多鐘
赞佩	讚佩
擢发	擢髮
郁律	鬱律
伙计	夥計
打干	打幹
花盆里	花盆裡
䜣	訢
院里	院裡
䜧	䜀
䜥	𧩙
䜤	鿁
𢙓	懀
灰蒙蒙	灰濛濛
涂謹申	涂謹申
晋	晉
范文正公	范文正公
间里	間裡
晒	曬
晓	曉
晖	暉
晔	曄
晕	暈
丑丑	醜醜
朱卷	硃卷
连三并四	連三併四
发际	髮際
智能机器人	智慧機器人
咸类	鹹類
余窍	餘竅
表停	錶停
毛姜	毛薑
丑名	醜名
通历史	通歷史
朴拙	樸拙
心系美	心繫美
壹郁	壹鬱
洪谷子	洪谷子
干死	乾死
四余	四餘
干的好事	幹的好事
点烟	點菸
几个	幾個
余缺	餘缺
头发生	頭發生
系膜	繫膜
于湘兰	于湘蘭
舍得	捨得
历法	曆法
心系群	心繫群
单于	單于
唇干	唇乾
花不要采	花不要採
总裁制	總裁制
特朗普	川普
𬮿	隑
几上	几上
赞一个	讚一個
逆钟	逆鐘
心系山	心繫山
格里高利历	格里高利曆
流风余韵	流風餘韻
怪里怪气	怪裡怪氣
圣赫勒拿	聖赫倫那
惧	懼
庆吊	慶弔
快快当当	快快當當
惨	慘
汤团	湯糰
准度	準度
积	積
国历届	國歷屆
洪范	洪範
历始	曆始
手链	手鍊
流動裝置	行動裝置
干咳	乾咳
惭	慚
静	靜
秆	稈
惮	憚
秃	禿
种	種
在山里	在山裡
于非闇	于非闇
惯	慣
干的	乾的
庼	廎
后苍	后蒼
系辞	繫辭
扪	捫
扫	掃
㳔	濧
页面	頁面
庞	龐
废	廢
横征暴敛	橫徵暴斂
墓志铭	墓志銘
朴樕	樸樕
应	應
干咽	乾咽
𬃊	櫍
这么干	這麼幹
㳠	澾
㳢	𣾷
㳽	瀰
品鉴	品鑑
馊	餿
六谷	六穀
这只容	這只容
庆	慶
余闰	餘閏
余闲	餘閒
商历	商曆
肉羹面	肉羹麵
悲筑	悲筑
干探	幹探
杂志	雜誌
瘪	癟
若干	若干
涂澤民	涂澤民
博采	博採
滩涂	灘涂
摄制	攝製
𠲥	𡅏
并发展	並發展
斯大林	史達林
这只是	這只是
于建嶸	于建嶸
窝	窩
党太尉	党太尉
函数里	函數裡
刘佳怜	劉佳怜
糊口	餬口
之钟	之鐘
郁堙不偶	鬱堙不偶
柜子	柜子
夸人	誇人
么女	么女
库尔德人	庫德人
敲扑	敲扑
𪔭	𪔵
干道	幹道
制冰	製冰
制冷	製冷
闫怀礼	閆懷禮
只身前	只身前
其余	其餘
中国国际信托投资公司	中國國際信托投資公司
采樵人	採樵人
夸容	誇容
赞歌	讚歌
于姓	于姓
𠯠	噅
铯钟	銫鐘
并到	併到
皮制服	皮制服
巨制	巨製
𠯟	哯
涂坤	涂坤
夸官	誇官
砰当	砰噹
三准	三準
那只在	那只在
封后	封后
托运	託運
于成龍	于成龍
胰脏	胰臟
籴	糴
于成龙	于成龍
棱角	稜角
懞直	懞直
面包	麵包
里通外敌	裡通外敵
尸罗精舍	尸羅精舍
制图	製圖
邹	鄒
普利策奖	普立茲獎
街庄	街庄
班里	班裡
六只	六隻
东游	東遊
㭎	棡
撒切尔	柴契爾
棺材里	棺材裡
几筵	几筵
朱批	硃批
𫔶	闑
皑	皚
钟不敲不响	鐘不敲不響
叶阳后	葉陽后
𫔎	鐍
𫔍	鐇
亦云	亦云
搋面	搋麵
皲	皸
旧表	舊錶
皱	皺
很凶	很兇
赠	贈
赡	贍
赢	贏
赣	贛
钟有	鐘有
反复	反覆
小只可	小只可
赵	趙
赶	趕
引发	引發
沈阳	瀋陽
学里	學裡
宗周钟	宗周鐘
资	資
赅	賅
中签订	中簽訂
赇	賕
赀	貲
赁	賃
赂	賂
赃	贓
赌	賭
境里程	境里程
冲刺	衝刺
赏	賞
赈	賑
赉	賚
赊	賒
赋	賦
赔	賠
很准	很準
赖	賴
加氢精制	加氫精制
赐	賜
赑	贔
赒	賙
改制成	改制成
赜	賾
赝	贗
赞	贊
赟	贇
赘	贅
赙	賻
赚	賺
赛	賽
大型钟面	大型鐘面
困倦	睏倦
𪟝	勣
𫚒	鮄
聖文森特和格林納丁斯	聖文森及格瑞那丁
梾	棶
梼	檮
干产	乾產
松绑	鬆綁
梦	夢
研制	研製
舍死忘生	捨死忘生
余悸	餘悸
干井	乾井
淫荡	淫蕩
烟具	菸具
索馬里蘭	索馬利蘭
干些	幹些
干了	幹了
这只用	這只用
手表決	手表決
干事	幹事
并吞下	並吞下
落发	落髮
扎囮	紮囮
恳托	懇託
谷类	穀類
太初历	太初曆
范文照	范文照
北回线	北迴線
蒌	蔞
蒉	蕢
蒋	蔣
于光远	于光遠
蒇	蕆
干娘	乾娘
郁邑	鬱邑
宝鉴	寶鑑
凄恻	悽惻
书面	書面
评鉴	評鑑
心长发短	心長髮短
秦沈客运	秦瀋客運
殖谷	殖穀
当当丁丁	當當丁丁
吸干	吸乾
盧瓦爾	羅亞爾
赞颂	讚頌
卷土重来	捲土重來
卷发	捲髮
尼日尔	尼日
烘干	烘乾
块	塊
坝	壩
坜	壢
坟	墳
坞	塢
买	買
乱	亂
𤋏	熡
坚	堅
嬴余	嬴餘
倦游	倦遊
书	書
习	習
乡	鄉
黄杰	黃杰
大只需	大只需
乔	喬
乐	樂
𬀩	暐
乌	烏
反复制	反複製
么	麼
义	義
版权信息	版權資訊
余粮	餘糧
只占算	只占算
显示表格	顯示表格
聖馬爾谷日	聖馬爾谷日
船只得	船只得
𬨂	軝
蒙特利尔	蒙特婁
于震寰	于震寰
划为	劃為
𬨎	輶
于会泳	于會泳
猜三划五	猜三划五
的个中	的箇中
遗传钟	遺傳鐘
凶器	兇器
舍弃	捨棄
石英钟	石英鐘
𥐯	𥖅
硷	鹼
涂鴻欽	涂鴻欽
冲锋	衝鋒
确	確
𥐻	碙
伟	偉
九个	九個
𥐰	𥕥
馄饨面	餛飩麵
三极管	三極體
硚	礄
硙	磑
硗	磽
澛	瀂
硕	碩
𥐟	礒
床席	床蓆
表针	錶針
工作台	工作檯
硅	矽
俭朴	儉樸
硁	硜
础	礎
干起来	幹起來
择	擇
铜范	銅範
于坚	于堅
”	」
这只须	這只須
余喘	餘喘
县里	縣裡
系上丝	繫上絲
蒸干	蒸乾
注脚	註腳
托儿	託兒
豆腐干	豆腐乾
才干扰	才干擾
星露谷物语	星露谷物語
破鉴	破鑑
老撾語	寮語
于德海	于德海
1字节	1位元組
几案	几案
游错	遊錯
上签写	上簽寫
冲冠发怒	沖冠髮怒
准新娘	準新娘
尸谏	尸諫
开哄	開鬨
面包罗	面包羅
彦	彥
上签约	上簽約
谷人	穀人
干酪	乾酪
挥杆	揮桿
煙農	菸農
郁症	鬱症
𠴢	𡄔
采血	採血
于帥	于帥
心系茶	心繫茶
译码	解碼
课余	課餘
奖杯	獎盃
细如发	細如髮
刮胡	刮鬍
个钟	個鐘
不吊，	不弔，
采空区	採空區
所羅門群島	索羅門群島
彨	彲
浪荡	浪蕩
球台	球檯
文征明	文徵明
采补	採補
郁蒸	鬱蒸
钟山	鐘山
铲头	剷頭
姜片	薑片
么姨	么姨
侯赛因	海珊
山重水复	山重水複
天文历表	天文曆表
数只能	數只能
复数	複數
横梁	橫樑
市里的	市裡的
䞐	賰
复字键	複字鍵
壽天里	壽天里
浑朴	渾樸
干奴才	乾奴才
䞍	䝼
䞌	𧵳
排骨面	排骨麵
䞎	𧶧
一天后	一天後
余毒	餘毒
于鳳至	于鳳至
区里的	區裡的
淋余土	淋餘土
吊客	弔客
情欲	情慾
点札	點劄
吊宴	弔宴
一哄而散	一鬨而散
本征	本徵
卡拉奇	喀拉蚩
嘱托	囑託
紅后假說	紅后假說
豔后	豔后
只占吉	只占吉
柜	櫃
干线	幹線
弄鬼吊猴	弄鬼弔猴
炼贫	鍊貧
柠	檸
升阳	昇陽
甄后	甄后
虎须	虎鬚
鹳	鸛
甜咸	甜鹹
萬一只	萬一只
分子云	分子雲
柽	檉
集团	集團
烟瘾	菸癮
𫖳	頵
诺曼底	諾曼第
焖	燜
焘	燾
𫖸	願
百谷	百穀
表盘	錶盤
堪培拉	坎培拉
解封后	解封後
北朝鲜	北韓
达·芬奇	達·文西
𫖯	頫
容范	容範
夸胜道强	誇勝道強
嘉芙蓮	凱薩琳
封为后	封為后
折篷	摺篷
洒家	洒家
被发入山	被髮入山
冲锋枪	衝鋒鎗
勃郁	勃鬱
舍入口	舍入口
卢浮宫	羅浮宮
口燥唇干	口燥唇乾
𨁴	𨅍
小只能	小只能
冲压	衝壓
馓	饊
火折子	火摺子
跻	躋
跸	蹕
解发佯狂	解髮佯狂
跶	躂
跷	蹺
践	踐
也門	葉門
斗蛐	鬥蛐
闯	闖
问	問
闭	閉
闬	閈
闫	閆
闪	閃
闩	閂
门	門
闷	悶
闶	閌
闵	閔
间	間
闳	閎
采盐	採鹽
闱	闈
闰	閏
人生天里	人生天里
闾	閭
闽	閩
闼	闥
闻	聞
径取	逕取
闹	鬧
闸	閘
9只	9隻
头里	頭裡
雷诺阿	雷諾瓦
寮采	寮寀
干量	乾量
𬍡	璗
干重	乾重
弘历	弘曆
昆调	崑調
宣泄	宣洩
于凤至	于鳳至
纡余	紆餘
范围	範圍
𬍛	瓅
队里	隊裡
质朴	質樸
斗龙	鬥龍
欺蒙	欺矇
帅	帥
奋斗	奮鬥
币	幣
帏	幃
總裁制	總裁制
师	師
纡回	紆迴
的发小	的髮小
忧郁	憂鬱
历物之意	厤物之意
帐	帳
待复	待覆
帜	幟
帘	簾
带	帶
帧	幀
沈丹高	瀋丹高
阳春面	陽春麵
唐纳德·特朗普	唐納·川普
帮	幫
狐借虎威	狐藉虎威
十杆	十桿
9只支持	9只支持
于国桢	于國楨
帱	幬
北岳	北嶽
帼	幗
帻	幘
这只可	這只可
排干	排乾
六么	六么
余留	餘留
咸批	鹹批
选手表明	選手表明
㐹	㑶
打干哕	打乾噦
㐽	偑
貝爾格萊德	貝爾格勒
食欲不振	食欲不振
一准	一準
㐷	傌
别辟	別闢
宋王台	宋王臺
不干不净	不乾不淨
于寶軒	于寶軒
万扎	萬紮
励	勵
短发生	短發生
小丑	小丑
腊毒	腊毒
蓄胡	蓄鬍
借寇兵	藉寇兵
朱庆余	朱慶餘
杰威尔	杰威爾
台风奖	台風獎
怅	悵
国	國
囵	圇
肴馔	肴饌
邁凱輪	麥拿輪
心荡	心蕩
园	園
刮雪	颳雪
赞辞	讚辭
腌臜	腌臢
馬里共和國	馬利共和國
百慕大	百慕達
精制住	精制住
撞钟	撞鐘
𩯒	𩯳
朝钟	朝鐘
劝	勸
面粉	麵粉
办	辦
酸姜	酸薑
戒烟	戒菸
冲散	衝散
浪游	浪遊
认准	認準
栉发工	櫛髮工
尸居余气	尸居餘氣
并为一体	併為一體
采为	採為
特蕾莎·梅	德蕾莎·梅伊
干落	乾落
薴烯	薴烯
雇请	僱請
采下	採下
脏胸	臟胸
法里，	法裡，
买凶	買兇
首席执行官	執行長
鮮于	鮮于
馁	餒
怼	懟
荐居	荐居
登巴萨	丹帕沙
印鉴	印鑑
范畴	範疇
蔂	虆
希特拉	希特勒
弄丑	弄醜
注定	註定
系上了	繫上了
托庇	託庇
折奏	摺奏
髭须	髭鬚
准保释	准保釋
蔷	薔
叱咤叱	叱咤叱
格丁根	哥廷根
蔼	藹
群丑	群醜
蔺	藺
蔹	蘞
蓬松	蓬鬆
律历志	律曆志
里面包	裡面包
馌	饁
操作系统	作業系統
回肠荡气	迴腸盪氣
埃荣冲	埃榮衝
一物克一物	一物剋一物
十出家	十出家
馍	饃
㔉	劚
電單車	機車
奇迹	奇蹟
批斗	批鬥
样	樣
仅	僅
南岳	南嶽
从	從
栾	欒
那只是	那只是
面粉红	面粉紅
仓	倉
辽沈	遼瀋
赞呗	讚唄
苹果干	蘋果乾
凶狠	兇狠
捞干	撈乾
树	樹
吸烟	吸菸
们	們
仪	儀
偻	僂
爱河里花子	愛河里花子
栅	柵
价	價
标	標
勾干	勾幹
栀	梔
坛坛罐罐	罈罈罐罐
涌水塘	涌水塘
栏	欄
栎	櫟
栉	櫛
席卷	席捲
栋	棟
码表示	碼表示
钟鸣	鐘鳴
烟碱	菸鹼
东冲西突	東衝西突
里铺	里舖
音不准	音不準
梨干	梨乾
干妹	乾妹
松掉	鬆掉
仆使	僕使
源代码	原始碼
荷爾斯泰因	霍爾斯坦
干妈	乾媽
鱼松	魚鬆
很松	很鬆
皇极历	皇極曆
安提瓜	安地卡
上签了	上簽了
很干	很乾
圣佩德罗苏拉	汕埠
䘞	𧜗
泡面	泡麵
䘛	𧝞
厨余	廚餘
余桶	餘桶
愛河里花子	愛河里花子
骠	驃
骡	騾
选手表现	選手表現
骣	驏
骤	驟
骥	驥
骦	驦
骧	驤
𩾎	𩽇
其一只	其一只
骐	騏
骑	騎
骒	騍
骓	騅
骔	騌
骕	驌
骖	驂
骗	騙
骘	騭
骙	騤
赞乐	讚樂
骛	騖
骜	驁
骝	騮
骞	騫
田里	田裡
骀	駘
骁	驍
骂	罵
骃	駰
东南亚国家联盟	東南亞國家協會
骅	驊
骆	駱
骇	駭
骈	駢
骉	驫
骊	驪
骋	騁
验	驗
骍	騂
丑杂	醜雜
吊问	弔問
药签	藥籤
熬制	熬製
急冲而下	急衝而下
发长	髮長
杂	雜
权	權
杀	殺
干刍	乾芻
蚊动牛斗	蚊動牛鬥
恕乏价催	恕乏价催
𣽷	瀃
惊栗	驚慄
杨	楊
杩	榪
来	來
杠	槓
条	條
提心吊胆	提心弔膽
自夸	自誇
诔赞	誄讚
体范	體範
月球历表	月球曆表
杰	傑
划入	劃入
杞宋无征	杞宋無徵
云笈七签	雲笈七籤
夸示	誇示
干池	乾池
写字台	寫字檯
舉手表	舉手表
心系红	心繫紅
㨫	㩜
录制	錄製
盆吊	盆弔
𬪩	醲
精松	精鬆
舍己救人	捨己救人
于友泽	于友澤
0出。	0齣。
党懷英	党懷英
𡞱	㜢
确系	確係
鲜于	鮮于
鸾鉴	鸞鑑
丧钟	喪鐘
预制	預製
钟表盘	鐘錶盤
雅范	雅範
并发重症	併發重症
德里达	德希達
丑徒	醜徒
托买	託買
丑奴儿	醜奴兒
伊斯兰教历史	伊斯蘭教歷史
痳疹	痳疹
数只包括	數只包括
朱理安历	朱理安曆
划行	划行
钟差	鐘差
标准	標準
眼睛里	眼睛裡
没干	沒幹
汹涌	洶湧
余声	餘聲
谷子敬	谷子敬
布谷鸟钟	布穀鳥鐘
轻松	輕鬆
浸卤	浸滷
石几	石几
心系兰	心繫蘭
盧旺達	盧安達
自制之力	自制之力
还冲	還衝
万只	萬隻
准货币	準貨幣
八周后	八周後
心系全	心繫全
六杆	六桿
一杆	一桿
曾朴	曾樸
采择	採擇
心系众	心繫眾
吁求	籲求
心系伊	心繫伊
祷	禱
采拾	採拾
新历史	新歷史
拉面罩	拉面罩
自制他	自制他
余辜	餘辜
阃范	閫範
佣钿	佣鈿
于洪區	于洪區
心系传	心繫傳
余辉	餘輝
佣钱	佣錢
凄戾	悽戾
祸	禍
碰钟	碰鐘
妖后	妖后
宾西法尼亚	賓夕法尼亞
星历	星曆
涂泽民	涂澤民
淀乃不耕之地	澱乃不耕之地
伊斯兰教历	伊斯蘭教曆
存折	存摺
凉席	涼蓆
朴质	樸質
山仔后	山仔后
四只	四隻
借机	藉機
日历	日曆
樂行童軍	羅浮童軍
顶多	頂多
并迭	并迭
余膏	餘膏
涌现	湧現
干瘦	乾瘦
喂喲	喂喲
面缸	麵缸
划算	划算
置言成范	置言成範
于冕	于冕
抿发	抿髮
喂喂	喂喂
戒煙	戒菸
坦桑尼亚	坦尚尼亞
松宽	鬆寬
坦桑尼亞	坦尚尼亞
瓦文萨	華勒沙
心系灾	心繫災
舂谷	舂穀
哗变	譁變
巧历	巧曆
硅藻	硅藻
耶律术烈	耶律朮烈
昆冈	崑岡
头发动	頭發動
于波	于波
水并流	水併流
世纪里	世紀裡
行人路權	行人路權
假里	假裡
𫘬	騱
迪拜	杜拜
𫘪	騵
小米面	小米麵
𫘨	騠
𫘧	騄
𫘦	騊
𥱔	𥵃
𫘤	騃
𫘣	駻
𫘝	駃
𫘜	馼
回响	迴響
回诵	迴誦
尸佼	尸佼
系着	繫着
理次发	理次髮
游仙	遊仙
病愈	病癒
數碼相機	數位相機
脊梁骨	脊梁骨
原文里	原文裡
后綜	后綜
拿破仑	拿破崙
镈	鎛
镋	钂
镊	鑷
廓子里	廓子里
镌	鐫
镏	鎦
镎	鎿
镁	鎂
镀	鍍
镃	鎡
镂	鏤
镅	鎇
氤郁	氤鬱
镇	鎮
镆	鏌
镙	鏍
镘	鏝
镛	鏞
镚	鏰
镝	鏑
镜	鏡
镟	鏇
镞	鏃
于克勒	于克勒
镐	鎬
镓	鎵
镒	鎰
镕	鎔
镔	鑌
镗	鏜
镖	鏢
臊子面	臊子麵
镨	鐠
镫	鐙
镪	鏹
镭	鐳
镬	鑊
镯	鐲
镮	鐶
镡	鐔
镠	鏐
皱折	皺摺
镢	钁
镥	鑥
镤	鏷
镧	鑭
镦	鐓
平平当当	平平當當
长	長
镱	鐿
镰	鐮
镳	鑣
镲	鑔
鉴于	鑑於
镴	鑞
镶	鑲
论文里	論文裡
城市里	城市裡
三余	三餘
六樓后座	六樓后座
于謙	于謙
历象	曆象
编程语言	程式語言
楊雅筑	楊雅筑
道瓊斯	道瓊
阿斯旺	亞斯文
打吨	打吨
于謹	于謹
吸煙	吸菸
便携式	可攜式
钟腰	鐘腰
丑态	醜態
这只不	這只不
榉	櫸
榈	櫚
榇	櫬
榅	榲
榄	欖
梅尔·吉布森	梅爾·吉勃遜
干头	幹頭
复钱	複錢
音准	音準
心繫农	心繫农
4周后	4周後
数字化	數位化
卤味	滷味
喂哟	喂喲
划具	划具
盘片	碟片
尽自	儘自
眼里	眼裡
仆仆	僕僕
发上指冠	髮上指冠
𣐤	欍
拒煙	拒菸
有够赞	有夠讚
王添灯	王添灯
舍出	捨出
𬷕	鵏
夸脱	夸脫
行凶	行兇
脑干	腦幹
余俗	餘俗
枪杆	槍桿
改征	改徵
瓷制	瓷製
洗炼	洗鍊
翱游	翱遊
𤇃	爄
复分解	複分解
貴子里	貴子里
箱里	箱裡
发胶	髮膠
朝鲜战争	韓戰
黄钟	黃鐘
于学忠	于學忠
甲胄	甲冑
馬占山	馬占山
谑	謔
噜	嚕
链表	鍊表
整发用品	整髮用品
酒气冲天	酒氣衝天
斗哄	鬥鬨
弱水三千只取一瓢	弱水三千只取一瓢
价川	价川
二余	二餘
心系社	心繫社
8杆	8桿
华严钟	華嚴鐘
谋干	謀幹
后蒼	后蒼
坱郁	坱鬱
赫梯	西臺
触须	觸鬚
复分析	複分析
好困	好睏
造钟	造鐘
古書云	古書云
蒙眬	矇矓
知识产权	智慧財產權
卷云	捲雲
踡局	踡跼
蚁后	蟻后
峃	嶨
仁贵	仁貴
梯冲	梯衝
吃碗面	吃碗麵
乙型肝炎	B型肝炎
涂谨申	涂謹申
坦荡荡	坦蕩蕩
丝发现	絲發現
郁纡	鬱紆
已占卜	已占卜
台佟	臺佟
𠛅	剾
𠛆	𠞆
薮	藪
制法	製法
余裕	餘裕
判断发	判斷發
不占吉凶	不占吉凶
采花	採花
烟斗	菸斗
采空采穗	採空採穗
隐几	隱几
理完发	理完髮
漂荡	漂蕩
五杆	五桿
征兆	徵兆
冲然	衝然
划拳	划拳
并网	併網
余部	餘部
丑声远播	醜聲遠播
上天里	上天里
皮托管	皮托管
放懞挣	放懞掙
格鲁吉亚	喬治亞
蚃干	蠁幹
拨谷	撥穀
生力面	生力麵
余年	餘年
假发票	假發票
余干	餘干
心系重	心繫重
征募	徵募
巴伦西亚	瓦倫西亞
霭	靄
烟灰	菸灰
渗漓	滲灕
夸才	誇才
涂绍煃	涂紹煃
下签署	下簽署
網絡遊戲	網路遊戲
采去	採去
链接	連結
挽歌	輓歌
哄堂	鬨堂
长几	長几
嘉肴	嘉肴
雇船	僱船
安提瓜和巴布達	安地卡及巴布達
咸蛋	鹹蛋
干路	幹路
语有云	語有云
包干	包幹
老挝人民民主共和国	寮人民民主共和國
由余	由余
圣马尔谷日	聖馬爾谷日
挽辞	輓辭
变征	變徵
挽输	輓輸
语法里	語法裡
筛	篩
筚	篳
的长发	的長髮
筜	簹
筑	築
渊里	淵裡
叶韻	叶韻
理发	理髮
叶韵	叶韻
钟不空则哑	鐘不空則啞
叶音	叶音
筹	籌
签	簽
筼	篔
余震	餘震
术赤	朮赤
加泰羅尼亞	加泰隆尼亞
8只支持	8只支持
筑邦	筑邦
霁	霽
丰標	丰標
辞汇	辭彙
惊	驚
百花历史	百花歷史
御敌	禦敵
𨸟	䧢
𨸘	𨽏
曲酒	麯酒
𨸄	䦘
𨸅	𨴗
𨸆	𨵩
台历	檯曆
𨸀	𨳕
𨸁	𨳑
𨸂	閍
𨸃	閐
𨸌	𨶮
惩	懲
𨸎	𨷲
惫	憊
惬	愜
𨸉	𨶀
𨸊	𨶏
𨸋	𨶲
人数里	人數裡
呆致致	呆緻緻
鹩	鷯
所云	所云
谷雨	穀雨
扑挞	扑撻
峰回	峰迴
蒲席	蒲蓆
钟摆	鐘擺
尸弃佛	尸棄佛
亮钟	亮鐘
游乐	遊樂
余责	餘責
炼句	鍊句
袋杆	袋桿
钟陈列	鐘陳列
乞力馬札羅	吉力馬札羅
犊	犢
皓发	皓髮
西昆	西崑
桑巴舞	森巴舞
𫚉	魟
𫚈	鱮
𫚕	鰤
𫚔	鮰
电杆	電桿
并科	併科
采矿	採礦
九杆	九桿
觚棱	觚稜
采石	採石
𫚙	鯆
哀挽	哀輓
国历经	國歷經
一出子	一齣子
𫚭	鱲
四舍五入	四捨五入
美发店	美髮店
低洼	低洼
发髻	髮髻
侦	偵
导游	導遊
机械表	機械錶
叶不二子	叶不二子
外面包	外面包
流動電話	行動電話
敢情欲	敢情欲
鳟	鱒
𬉼	熰
下课钟	下課鐘
干雷	乾雷
火并	火併
侩	儈
扎根	紮根
偎干	偎乾
数只	數隻
于涛	于濤
强干	強幹
回转	迴轉
崂	嶗
崃	崍
崄	嶮
可卡因	古柯鹼
缓征	緩徵
干稿	乾稿
辩斗	辯鬥
美发馆	美髮館
面包含	面包含
䴘	鷈
皮里阳秋	皮裡陽秋
配制饲料	配制飼料
夸口	誇口
夏历史	夏歷史
崭	嶄
饼干	餅乾
出租车	計程車
面粉碎	面粉碎
于爾根	于爾根
海洛英	海洛因
𡒄	壈
燎发	燎髮
𬱟	頠
只身为	只身為
舍入	捨入
𬱖	頔
铲出	剷出
王侯后	王侯后
心系远	心繫遠
倾	傾
吾为之范我驰驱	吾爲之範我馳驅
理查德	理察
心系近	心繫近
征聘	徵聘
谁干的	誰幹的
干回付	乾回付
文学志	文學誌
闪存	快閃記憶體
嗫	囁
心系妻	心繫妻
沈海铁路	瀋海鐵路
中签写	中簽寫
嗳	噯
卷筒	捲筒
斓	斕
郁郁苍苍	鬱鬱蒼蒼
复对数	複對數
心系妇	心繫婦
鹰雕	鹰鵰
抹干	抹乾
秒钟	秒鐘
坑里	坑裡
皮里春秋	皮裡春秋
𨅫	𨇞
郁郁葱葱	鬱鬱蔥蔥
𨅬	躝
汹	洶
澹荡	澹蕩
磨制	磨製
这只	這隻
老挝	寮國
丰度	豐度
狄安娜	黛安娜
硗确	磽确
巡回	巡迴
系念	繫念
杠杆	槓桿
系心	繫心
不好干预	不好干預
𦨩	𦪽
一个	一個
恶直丑正	惡直醜正
仆固怀恩	僕固懷恩
钟在寺里	鐘在寺裡
悬臂梁	懸臂樑
钟形	鐘形
四杆	四桿
余地	餘地
舆	輿
环游	環遊
漓江	灕江
弥山遍野	瀰山遍野
遗迹	遺蹟
舱	艙
舰	艦
采样	採樣
舻	艫
舣	艤
香煙	香菸
声卡	音效卡
回风	迴風
粝	糲
苏里南	蘇利南
辟筑	闢築
郁郁青青	郁郁青青
劳拉	蘿拉
酒肴	酒肴
鳏	鰥
万历朝鲜战争	萬曆朝鮮戰爭
两余	兩餘
卤面	滷麵
余映	餘映
成于思	成於思
烟叶	菸葉
烟台	煙臺
超级杯	超級盃
发结	髮結
某只	某隻
九周后	九周後
大只在	大只在
斗而铸锥	鬥而鑄錐
李连杰	李連杰
大目干连	大目乾連
调制解调器	數據機
石勒蘇益格	什勒斯維希
三个	三個
余明	餘明
行事历	行事曆
殿钟自鸣	殿鐘自鳴
寸发千金	寸髮千金
椁	槨
小型钟表	小型鐘錶
乾象曆	乾象曆
只身上無	只身上無
枯干	枯乾
杯干	杯乾
圣后	聖后
椝	槼
回文构词	迴文構詞
椟	櫝
椠	槧
椢	槶
椤	欏
椫	樿
椭	橢
椮	槮
流動網絡	行動網路
郓	鄆
酥松	酥鬆
心系震	心繫震
比利牛斯	庇里牛斯
至多只	至多只
荡寇	蕩寇
心系泰	心繫泰
所占星	所占星
电波钟	電波鐘
篓	簍
篯	籛
篮	籃
授勋	授勳
通历	通曆
粤	粵
于震環	于震環
点半钟	點半鐘
呗赞	唄讚
仙游	仙遊
争奇斗艳	爭奇鬥豔
安提瓜和巴布达	安地卡及巴布達
篱	籬
斯皮尔伯格	史匹柏
苏醒	甦醒
八杆	八桿
余〇	餘〇
编采	編採
干嚎	乾嚎
恒	恆
漫卷	漫捲
恋	戀
准直	準直
于默奧	于默奧
于默奥	于默奧
恺	愷
恻	惻
恸	慟
恹	懨
恼	惱
飞扎	飛紮
恳	懇
恶	惡
無煙日	無菸日
勋劳	勳勞
伯利茲	貝里斯
鹄	鵠
小型钟	小型鐘
马德钟	馬德鐘
國際象棋	西洋棋
梁上君子	梁上君子
鹀	鵐
托过	託過
标标致致	標標致致
鸡腿面	雞腿麵
增辟	增闢
不丑	不醜
面条目	面條目
干流	幹流
固定制	固定制
所云云	所云云
注生娘娘	註生娘娘
干济	幹濟
一吊钱	一吊錢
炒面	炒麵
枪支	槍枝
寝	寢
鹕	鶘
鹔	鷫
𤦀	瓕
寻	尋
撷	擷
对	對
寿	壽
导	導
咸水	鹹水
么孃	么孃
烩面	燴麵
撵	攆
柏林墙	柏林圍牆
卷尾猴	捲尾猴
被夸	被誇
么子	么子
丑小鸭	醜小鴨
鹜	鶩
熏心	薰心
郁郁寡欢	鬱鬱寡歡
斗幌子	鬥幌子
撸	擼
颜范	顏範
磬钟	磬鐘
鹙	鶖
贤后	賢后
事里	事裡
台球	檯球
荷尔斯泰因	霍爾斯坦
岖	嶇
岗	崗
盘里	盤裡
心系健	心繫健
游程	遊程
岘	峴
岚	嵐
岛	島
钟表速	鐘錶速
岁	歲
岂	豈
白粉面	白粉麵
鹠	鶹
里氏地震规模	芮氏地震規模
采编	採編
䂵	碽
岿	巋
黄历史	黃歷史
岭	嶺
发卷	髮捲
风后，	風後，
卷舌	捲舌
心系世	心繫世
赞美	讚美
心系东	心繫東
黄发	黃髮
捉奸徒	捉奸徒
鹨	鷚
斗武	鬥武
心系万	心繫萬
斗不过	鬥不過
吐哺捉发	吐哺捉髮
心系一	心繫一
凭吊	憑弔
夸克	夸克
浑	渾
篑	簣
特拉华	德拉瓦
撑	撐
互联网	網際網路
那只须	那只須
心系中	心繫中
丰标不凡	丰標不凡
只身段	只身段
采到	採到
采制	採制
质数里	質數裡
复查	複查
发雕	髮雕
鹲	鸏
辎	輜
面塑	麵塑
眼干	眼乾
百花历	百花曆
𤈷	㷿
傲霜斗雪	傲霜鬥雪
两出	兩齣
勋业	勳業
斗打	鬥打
斗丽	鬥麗
属托	屬託
涂善妮	涂善妮
准点	準點
颡	顙
流风余俗	流風餘俗
甲后路	甲后路
帛尸梨	帛尸梨
准拟	準擬
拈须	拈鬚
天里村	天里村
大历险	大歷險
钟纽	鐘紐
采树种	採樹種
包谷	包穀
王余鱼	王餘魚
事有斗巧	事有鬥巧
寇准	寇準
于濤	于濤
登巴薩	丹帕沙
仙后座	仙后座
干薪	乾薪
路图里	路圖裡
僮仆	僮僕
皆准	皆準
渠冲	渠衝
許聖杰	許聖杰
怒发冲冠	怒髮衝冠
不好干預	不好干預
寇仇	寇讎
复线	複線
后北街	后北街
沈山铁路	瀋山鐵路
郑苹如	鄭蘋如
金表示	金表示
粪秽蔑面	糞穢衊面
翁子里	翁子里
私煙	私菸
炼	煉
𥭉	𥵊
点	點
炀	煬
请君入瓮	請君入甕
炉	爐
·威尔士	·威爾士
炜	煒
佐治亚	喬治亞
鲼	鱝
余韵	餘韻
佐治亞	喬治亞
克羅地亞	克羅埃西亞
金装玉里	金裝玉裡
字码表	字碼表
府干卿	府干卿
尊后	尊后
形而上学	形上學
一伙人	一伙人
银朱	銀硃
御岳山	御嶽山
编码表	編碼表
后海灣	后海灣
内哄	內鬨
干当	幹當
美发师	美髮師
冲倒	衝倒
所罗门群岛	索羅門群島
折扇	摺扇
干片	乾片
瘅	癉
瘆	瘮
大衍历史	大衍歷史
𫚖	鮆
相斗	相鬥
煨干	煨乾
面食	麵食
心系夫	心繫夫
屯里	屯裡
干物	乾物
永历史	永歷史
心系大	心繫大
佛得角	維德角
咨询	諮詢
于少保	于少保
郁勃	鬱勃
余暇	餘暇
干员	幹員
日心历表	日心曆表
争奇斗异	爭奇鬥異
电视里	電視裡
只占卜	只占卜
谷神	穀神
只身上的	只身上的
虎斗	虎鬥
这只会	這只會
人如风后入江云	人如風後入江雲
顺风后	順風後
色欲	色慾
檩	檁
六天后	六天後
恽	惲
饤	飣
摧坚获丑	摧堅獲醜
瘗	瘞
反应制得	反應製得
那只需	那只需
𬘡	絪
征效	徵效
吊纸	弔紙
换只	換隻
糊里糊涂	糊裡糊塗
獨裁制	獨裁制
儒略改革历	儒略改革曆
区里有	區裡有
能自制	能自制
𬳵	駓
拾沈	拾瀋
万旗	万旗
线图里	線圖裡
𬳽	駪
𬳿	駼
这只允	這只允
㖊	噚
族里	族裡
知識產權局	知識產權署
啭	囀
啬	嗇
啯	嘓
啮	齧
啧	嘖
于美人	于美人
旱干	旱乾
网游	網遊
啸	嘯
啴	嘽
染发生	染發生
想象	想像
啰	囉
木梁	木樑
于云鹤	于雲鶴
征收	徵收
4只支援	4只支援
遨游	遨遊
2只支持	2只支持
心脏痳痹	心臟痲痺
水里鳳林	水里鳳林
托病	託病
门帘	門帘
尔冬升	爾冬陞
铕	銪
波利尼西亚	玻里尼西亞
波利尼西亞	玻里尼西亞
划船	划船
烫一次发	燙一次髮
和制汉	和製漢
测不准	測不準
苧悴	薴悴
中庄子	中庄子
纸烟	紙菸
斗叠	鬥疊
傳位于四太子	傳位于四太子
闯荡	闖蕩
修筑前	修築前
剪发	剪髮
0只支援	0只支援
嫌好道丑	嫌好道醜
大只	大隻
吊词	弔詞
柜柳	柜柳
孙	孫
瘾	癮
范文同	范文同
榨干	榨乾
铀	鈾
为准	為準
竞斗	競鬥
卷尺	捲尺
孪	孿
好斗蓬	好斗蓬
铅	鉛
白里透红	白裡透紅
應制得	應制得
𤠋	㺏
吊诡	弔詭
复审	覆審
芗	薌
芜	蕪
寺钟	寺鐘
镇里	鎮裡
松口	鬆口
节	節
笑里藏刀	笑裡藏刀
一出戏	一齣戲
芈	羋
天克地冲	天克地衝
晞发	晞髮
采莲	採蓮
采获	採獲
考征	考徵
𬘫	綄
俯冲	俯衝
心系阮	心繫阮
注失	註失
斗艳	鬥豔
香烟	香菸
词里	詞裡
树林里	樹林裡
折子戲	折子戲
系上绳	繫上繩
电码表	電碼表
松口镇	松口鎮
十出头	十出頭
折子戏	折子戲
么爹	么爹
筑阳	筑陽
后天	後天
心系京	心繫京
斗闷	鬥悶
只身後	只身後
心系人	心繫人
蜡月	蜡月
鼓噪	鼓譟
别扭	彆扭
采种	採種
智能电话	智慧型電話
心系黄	心繫黃
结余	結餘
褒赞	褒讚
心系五	心繫五
蒙汜	濛汜
聖吉斯納域斯	聖克里斯多福及尼維斯
台风稳健	台風穩健
纵欲	縱慾
带征	帶徵
宇航员	太空人
啊喂	啊喂
筑後	筑後
术忽	朮忽
喲喂	喲喂
采办	採辦
分钟里	分鐘裡
涞	淶
魯賓斯·巴里切羅	魯本·巴瑞切羅
自制你	自制你
复杂	複雜
涛	濤
干苔	乾苔
萊特灣	雷伊泰灣
穑	穡
多只含	多只含
亿周后	億周後
心系汶	心繫汶
并曰入淀	並曰入澱
列支敦士登	列支敦斯登
求知欲	求知慾
穷	窮
面包容	面包容
南宫适	南宮适
主钟曲线	主鐘曲線
阳谷	陽穀
游河	遊河
心系江	心繫江
杆頭	桿頭
普咚咚	普鼕鼕
肉欲	肉慾
懑	懣
懒	懶
冶游	冶遊
绿发	綠髮
对表达	對表達
辟土	闢土
于立成	于立成
卤子	滷子
之余	之餘
托咎	託咎
只采	只採
余霞	餘霞
杰伦	杰倫
决斗	決鬥
范文程	范文程
遏制	遏制
润	潤
辟地	闢地
深山里	深山裡
圣人历	聖人曆
发辫	髮辮
基准	基準
黑山共和國	蒙特內哥羅共和國
猬	蝟
献	獻
对准	對準
坐如钟	坐如鐘
猡	玀
𢫞	𢶫
所占卜	所占卜
一并	一併
私烟	私菸
同余	同餘
点里	點裡
人机交互	人機互動
抵御	抵禦
不来梅	不萊梅
中型钟表面	中型鐘表面
逾闲	踰閑
猎	獵
瞩托	矚託
朴子里	朴子里
猃	獫
丑比	醜比
数只可	數只可
猕	獼
冲决	衝決
井里	井裡
林杰樑	林杰樑
冲冠	衝冠
卤制	滷製
传位于四太子	傳位于四太子
杆身	桿身
长得丑	長得醜
埃博拉	伊波拉
𫞩	璊
计划	計劃
选	選
文采郁郁	文采郁郁
剪其发	剪其髮
生物钟	生物鐘
叶叶琹	葉叶琹
多半只	多半只
威棱	威稜
无业游民	無業游民
肝郁	肝鬱
闹钟	鬧鐘
夸过	誇過
郁闭	鬱閉
杆头	桿頭
郁闷	鬱悶
干大事	幹大事
袖里	袖裡
爽荡	爽蕩
赢余	贏餘
唾余	唾餘
树干	樹幹
𫖮	顗
风物志	風物誌
弥	彌
兼并	兼併
杜琪峰	杜琪峯
尘	塵
双雕	雙鵰
尔	爾
只身上沒	只身上沒
应制得	應制得
丑头怪脸	醜頭怪臉
将	將
尽	盡
尸	屍
这只比	這只比
尴	尷
青山一发	青山一髮
园里	園裡
魔表	魔錶
游离	游離
尧	堯
只身上没	只身上沒
一干人	一干人
共和历史	共和歷史
葫芦里卖甚么药	葫蘆裡賣甚麼藥
奋	奮
有征战	有征戰
匪干	匪幹
一只	一隻
詩云	詩云
词干	詞幹
有征戰	有征戰
准保	準保
三極管	三極體
屡顾尔仆	屢顧爾僕
看钟	看鐘
斗殴	鬥毆
冷面天使	冷面天使
农历	農曆
复平面	複平面
游牧	遊牧
丰采	丰采
𤽯	㿧
托疾	託疾
并一不二	併一不二
盐余	鹽餘
下签写	下簽寫
哗	嘩
哕	噦
哔	嗶
哓	嘵
哒	噠
哑	啞
解雇	解僱
哟	喲
哝	噥
哜	嚌
哙	噲
回复你	回覆你
每只	每隻
西谷米	西谷米
响	響
西历史	西歷史
余九	餘九
识	識
诇	詗
评	評
诅	詛
诂	詁
诃	訶
纯朴	純樸
证	證
诎	詘
诏	詔
辟田	闢田
词	詞
诊	診
翻涌	翻湧
诈	詐
诉	訴
𩧰	䮝
诗	詩
诔	誄
试	試
闵采尔	閔採爾
诓	誆
𩧶	𩣏
译	譯
诞	誕
诟	詬
𩧺	駶
话	話
诚	誠
诛	誅
诘	詰
诙	詼
详	詳
诧	詫
诤	諍
于學忠	于學忠
询	詢
诣	詣
诠	詮
诡	詭
诮	誚
误	誤
诬	誣
语	語
诪	譸
格林納達	格瑞那達
诨	諢
诩	詡
诶	誒
请	請
说	說
诵	誦
诲	誨
以太网	乙太網
诰	誥
诱	誘
课	課
诿	諉
诼	諑
诽	誹
诺	諾
读	讀
诸	諸
诹	諏
采集	採集
大明历史	大明歷史
奥	奧
尸臣	尸臣
冲来	衝來
每每只	每每只
涂长望	涂長望
征圣	徵聖
夸大	誇大
夸夸	誇誇
台式电脑	桌上型電腦
披发	披髮
白发	白髮
对准钟表	對準鐘錶
一伙	一夥
临潼斗宝	臨潼鬥寶
交托	交託
干的事	幹的事
科摩羅	葛摩
茔	塋
1天后	1天後
郁血	鬱血
马尔代夫	馬爾地夫
茏	蘢
茎	莖
债累累	債纍纍
于冠华	于冠華
建筑前	建築前
蹭棱子	蹭稜子
放荡	放蕩
残奥会	帕運會
大伙	大夥
发引千钧	髮引千鈞
中型钟表	中型鐘錶
采茶	採茶
扎起	紮起
游目骋怀	遊目騁懷
字里行间	字裡行間
肤	膚
茧	繭
千扎	千紮
丝恩发怨	絲恩髮怨
党进	党進
钢制	鋼製
杆枪	桿槍
斗心眼	鬥心眼
性征	性徵
吕宋烟	呂宋菸
北山索面	北山索麵
面店	麵店
征兵	徵兵
自由泳	自由式
烫完发	燙完髮
素数里	素數裡
电梯里	電梯裡
竹制	竹製
伊里布	伊里布
系怀	繫懷
悬钟	懸鐘
羡余	羨餘
精干	精幹
䌸	縳
划一槳	划一槳
干料	乾料
肴	餚
留发生	留發生
尽尽	儘儘
紧	緊
年代里	年代裡
韩国制	韓國製
飘发自由女神	飄髮自由女神
干茨腊	乾茨臘
死里求生	死裡求生
梦游	夢遊
使其斗	使其鬥
有征伐	有征伐
1只支援	1只支援
高清愿	高清愿
游春	遊春
调准	調準
卢棱伽	盧稜伽
于占元	于占元
径行	逕行
趙威后	趙威后
樯	檣
穷发	窮髮
横	橫
出乖露丑	出乖露醜
拒烟	拒菸
农民历	農民曆
打印度	打印度
游星	遊星
瑶签	瑤籤
樱	櫻
复目	複目
准定	準定
竞	競
行家里手	行家裡手
竖	豎
采菊	採菊
鸡丝面	雞絲麵
郁郁不平	鬱鬱不平
蒙头转	矇頭轉
干支支	乾支支
乌发	烏髮
潜意识里	潛意識裡
𥆧	瞤
皇后	皇后
颈	頸
颉	頡
颊	頰
颋	頲
颌	頜
颍	潁
颎	熲
颏	頦
颀	頎
荡然	蕩然
四舍六入	四捨六入
颃	頏
预	預
颅	顱
领	領
颇	頗
题	題
颙	顒
颚	顎
艳	艷
颜	顏
额	額
颞	顳
颟	顢
颐	頤
椒面	椒麵
颒	頮
颓	頹
颔	頷
颕	頴
颖	穎
颗	顆
春香斗学	春香鬥學
吊钟	吊鐘
𤞤	玁
颠	顛
艷后	艷后
颢	顥
颣	纇
浩荡	浩蕩
颥	顬
颦	顰
颧	顴
后发座	后髮座
岽	崬
蕭士達高維契	蕭士塔高維奇
点钟	點鐘
斗剑	鬥劍
采石之戰	采石之戰
蛮干	蠻幹
酿	釀
大笨钟	大笨鐘
棱子	稜子
亮丑	亮醜
𬒗	𥗽
钟匠	鐘匠
酾	釃
威斯特法倫	威斯伐倫
口干犯	口干犯
航天器	太空飛行器
秃发	禿髮
广征	廣徵
丑女	醜女
𬒈	礐
秤杆	秤桿
2天后	2天後
罗马历	羅馬曆
嫔	嬪
嫒	嬡
余光生	余光生
干湿	乾濕
甜、咸	甜、鹹
防范	防範
自制一下	自制一下
手里	手裡
核准	核准
自制的能	自制的能
吊祭	弔祭
那只用	那只用
干面	乾麵
咸派	鹹派
提摩太后书	提摩太後書
园游会	園遊會
发脚	髮腳
凶嫌	兇嫌
心系女	心繫女
竖起脊梁	豎起脊梁
疏松	疏鬆
心系舞	心繫舞
鿒	鿓
玉米面	玉米面
永历	永曆
厢	廂
厣	厴
厦	廈
厨	廚
厩	廄
歲聿云暮	歲聿云暮
厮	廝
电子表格	電子表格
余五	餘五
狱里	獄裡
自制我	自制我
回路	迴路
县	縣
厂	廠
厅	廳
历	歷
余事	餘事
厉	厲
只采声	只采聲
压	壓
厌	厭
厍	厙
不太准	不太準
厐	龎
厕	廁
干暖	乾暖
赫丘勒·波洛	赫丘勒·白羅
余二	餘二
姜末	薑末
显示钟表	顯示鐘錶
畅游	暢遊
浅淀	淺澱
巴塞隆拿	巴塞隆納
乌龙面	烏龍麵
采证	採證
埚	堝
莫桑比克	莫三比克
惊钟	驚鐘
布基纳法索	布吉納法索
握发	握髮
大只会	大只會
干草	乾草
百只	百隻
复句	複句
面坊	麵坊
俩	倆
复叶	複葉
大只有	大只有
赞羡	讚羨
沉郁	沉鬱
鹤吊	鶴弔
尽速	儘速
衅	釁
紧追不舍	緊追不捨
机械钟表	機械鐘錶
有只容	有只容
自干五	自乾五
见棱见角	見稜見角
管制	管制
衔	銜
衬	襯
折台	摺檯
衮	袞
心系两	心繫兩
谷子	穀子
占高枝儿	佔高枝兒
补	補
尸位素餐	尸位素餐
了望	瞭望
准线	準線
牛只	牛隻
向往	嚮往
能干	能幹
單向	單向
去山里	去山裡
荞麦面	蕎麥麵
洪都拉斯	宏都拉斯
抵触	牴觸
赞赏	讚賞
挽曲	輓曲
电视台风	電視台風
丑陋	醜陋
创制	創製
现	現
玱	瑲
折叠	摺疊
愛德文	愛德溫
玺	璽
斗叶儿	鬥葉兒
數碼音樂	數位音樂
后髮座	后髮座
艳后	艷后
丑死	醜死
科尼亚克期	科尼亞克期
玮	瑋
环	環
玑	璣
周历	周曆
玚	瑒
玛	瑪
余零	餘零
玙	璵
𪎈	䴬
𪎉	麲
打卤	打滷
𪎋	䴴
一周后	一周後
打印	列印
更钟意	更鍾意
膨松	膨鬆
干干	乾乾
于志寧	于志寧
圈梁	圈樑
发饰	髮飾
水准	水準
击钟	擊鐘
打卡钟	打卡鐘
维尔京群岛	維京群島
新井里美	新井里美
丑言	醜言
吊取	弔取
下注解	下注解
酒曲	酒麴
吉征	吉徵
穆罕默德历	穆罕默德曆
提子干	提子乾
数只限	數只限
艾滋	愛滋
毛里塔尼亞	茅利塔尼亞
家丑	家醜
毛里塔尼亚	茅利塔尼亞
骨灰坛	骨灰罈
心系昌	心繫昌
天台	天台
䍀	繿
䍁	繸
结发表	結發表
这钟	這鐘
佣錢	佣錢
卤豆	滷豆
干略	幹略
冬山庄	冬山庄
克期	剋期
于贈	于贈
殓	殮
殒	殞
殚	殫
殇	殤
余晖	餘暉
裁制	裁製
殁	歿
残	殘
阆	閬
殴	毆
1只	1隻
蛊	蠱
殡	殯
采选	採選
发根	髮根
划著	劃著名
制件	製件
手表示	手表示
据云	據云
醋坛	醋罈
夸特	夸特
范字	範字
游骑兵	遊騎兵
姓么	姓么
优	優
阁府	閤府
于格	于格
数罪并罚	數罪併罰
须鲨	鬚鯊
煙鹼	菸鹼
北回铁路	北迴鐵路
尸罗	尸羅
防御	防禦
干梅	乾梅
起哄	起鬨
余力為	余力為
捶炼	捶鍊
里海茨	里海茨
當奴·特朗普	唐納·川普
店里	店裡
凶恶	兇惡
呙	咼
斗犀台	鬥犀臺
呛	嗆
奸杀	姦殺
巴尔米拉环礁	帕邁拉環礁
呐	吶
潜水钟	潛水鐘
多只用	多只用
呕	嘔
呗	唄
呖	嚦
卷图	捲圖
晒谷	曬穀
单打独斗	單打獨鬥
这只能	這只能
筑紫	筑紫
凶枪	兇槍
对华发	對華發
神游	神遊
干嘛	幹嘛
岳岳	嶽嶽
𬜬	蔄
南屏晚钟	南屏晚鐘
科范	科範
煙葉	菸葉
么喝	么喝
争妍斗艳	爭妍鬥豔
语云	語云
台子女	台子女
桌历	桌曆
斗勇	鬥勇
紙煙	紙菸
订	訂
于阗	于闐
于震	于震
墨沈	墨瀋
丑声	醜聲
折裙	摺裙
原钟	原鐘
抽签	抽籤
轪	軑
殴斗	毆鬥
划來划去	划來划去
婳	嫿
金发	金髮
婴	嬰
婶	嬸
舍堕	捨墮
潭里	潭裡
阿布扎比	阿布達比
贻范	貽範
昽	曨
修胡刀	修鬍刀
迥然回异	迥然迴異
讧	訌
阿里埃勒·沙龍	艾里爾·夏隆
布什	布希
6只支援	6只支援
授时历	授時曆
莱	萊
莳	蒔
莲	蓮
于逸堯	于逸堯
莴	萵
素发	素髮
莶	薟
莹	瑩
莸	蕕
莺	鶯
阿里埃勒·沙龙	艾里爾·夏隆
温洛克期	溫洛克期
莅	蒞
上签署	上簽署
三扎	三紮
原子钟	原子鐘
抓奸	抓姦
熏陶	薰陶
托克逊	託克遜
汇编	彙編
3余	3餘
游踪	遊蹤
丰儀	丰儀
余子明	余子明
宫里	宮裡
对表现	對表現
获匪其丑	獲匪其醜
軟件	軟體
游逛	遊逛
敦朴	敦樸
划得來	划得來
更钟情	更鍾情
讫	訖
痳木	痳木
铜制	銅製
面厂	麵廠
于爾里克	于爾里克
倚闲	倚閑
怒火冲天	怒火衝天
那只可	那只可
涂序瑄	涂序瑄
雕悍	鵰悍
棱等登	稜等登
你夸	你誇
占头筹	佔頭籌
𨰾	鎷
𨰿	釳
撤并	撤併
准新郎	準新郎
面团	麵團
有准	有準
法属圭亚那	法屬蓋亞那
丰姿	丰姿
讬	託
多余	多餘
惴栗	惴慄
上签字	上簽字
党姓	党姓
首席运营官	營運長
干菜	乾菜
面包括	面包括
须须	鬚鬚
棱棱	稜稜
戈爾巴喬夫	戈巴契夫
金链	金鍊
复印	複印
索馬里	索馬里
得力干将	得力幹將
瑷	璦
畴	疇
党進	党進
术虎高	朮虎高
荡女	蕩女
𢘞	𢣭
朱砂	硃砂
译文里	譯文裡
心系浙	心繫浙
畅	暢
结发育	結發育
棱线	稜線
回历	回曆
回光返照	迴光返照
阿拉伯聯合酋長國	阿拉伯聯合大公國
拨	撥
里氏规模	芮氏規模
电线杆	電線桿
庙里	廟裡
拢	攏
拣	揀
拥	擁
拦	攔
借资	藉資
弥漫	瀰漫
干唱	乾唱
𢋈	㢝
隱几	隱几
汇刊	彙刊
福尔马林	福馬林
钟被	鐘被
担	擔
卷逃	捲逃
超赞	超讚
拟	擬
舍身	捨身
心余	心餘
爷	爺
那只	那隻
脊梁背	脊梁背
埔里社	埔裏社
姜老辣	薑老辣
黄诗杰	黃詩杰
名单于	名單於
零天后	零天後
手表态	手表態
台面化	檯面化
十扎	十紮
纪	紀
宽余	寬餘
划一桨	划一槳
只身首	只身首
𥧂	𥨐
兀术	兀朮
手游	手遊
欲海难填	欲海難填
秀发起	秀發起
蓄须	蓄鬚
数只比	數只比
古书云	古書云
干巴	乾巴
千余	千餘
郧	鄖
郦	酈
郸	鄲
𫂈	䉬
嘉谷	嘉穀
乐游原	樂遊原
证谏	証諫
泞	濘
谷场	穀場
郏	郟
年里约	年里約
泪	淚
腐干	腐乾
游园	遊園
松柔	鬆柔
昂山素姬	翁山蘇姬
泷	瀧
泸	瀘
泺	濼
泻	瀉
泼	潑
泽	澤
思如泉涌	思如泉湧
丰茸	丰茸
心系生	心繫生
多只包括	多只包括
显示表头	顯示表頭
帝后臺	帝后臺
精制服	精制服
干村沙	乾村沙
馬斯特里赫特	馬斯垂克
侥幸	僥倖
揾	搵
代理发行	代理發行
匮	匱
心系困	心繫困
发乳	髮乳
心系国	心繫國
匦	匭
区	區
医	醫
妖气冲天	妖氣衝天
凶残	兇殘
历命	曆命
留发展	留發展
蒙昧无知	矇昧無知
泪如泉涌	淚如泉湧
船只能	船只能
复穗	複穗
明范	明範
匀	勻
码表	碼錶
心系四	心繫四
餍	饜
赞词	讚詞
煙品	菸品
托梦	託夢
上签发	上簽發
武丑	武丑
理一次发	理一次髮
洗发	洗髮
一干二净	一乾二淨
頂多	頂多
凤梨干	鳳梨乾
莽荡	莽蕩
旧钟	舊鐘
𬹼	齘
夹衣	袷衣
限制	限制
凶刀	兇刀
冲头阵	衝頭陣
调表	調錶
通心面	通心麵
盛赞	盛讚
尽其所有	儘其所有
电子制表	電子製表
伊斯兰历	伊斯蘭曆
俯卧撑	伏地挺身
五只	五隻
印制	印製
打印機	印表機
跳梁小丑	跳樑小丑
数码相机	數位相機
赵威后	趙威后
干校	幹校
樗里子	樗里子
卢塞恩	琉森
骎	駸
只手遮天	隻手遮天
并肩子	併肩子
泛游	泛遊
回荡	迴蕩
尸魂界	尸魂界
重制	重製
下梁	下樑
头乱发	頭亂髮
屋里	屋裡
钻	鑽
裆	襠
鳳凰于飛	鳳凰于飛
装	裝
裈	褌
开普勒	克卜勒
凶险	兇險
斗士	鬥士
炽	熾
盏	盞
瞳蒙	瞳矇
钿	鈿
裢	褳
裣	襝
太丑	太醜
裤	褲
裥	襉
骀荡	駘蕩
散荡	散蕩
𦰴	䕳
𡭜	𡮉
采得	採得
征吏	徵吏
征实	徵實
丑媳妇	醜媳婦
于樹潔	于樹潔
钨	鎢
回圈	迴圈
汉诺威	漢諾瓦
干吗	幹嗎
雪里	雪裡
自制能力	自制能力
反烟	反菸
征启	徵啟
笋干	筍乾
数只在	數只在
漓湘	灕湘
耢	耮
稽征	稽徵
耧	耬
透辟	透闢
耻	恥
监	監
耸	聳
盐	鹽
于廣洲	于廣洲
为鉴	為鑑
鹤峰县	鶴峯縣
2余	2餘
复阅	複閱
炖	燉
钤	鈐
6杆	6桿
转托	轉託
钦	欽
盖	蓋
托管国	托管國
汇辑	彙輯
沈北	瀋北
这出乎	這出乎
划進	划進
真丑	真醜
史鉴	史鑑
文丑	文丑
汇纂	彙纂
于寘	于寘
中境里	中境里
炝	熗
里白	裏白
配制	配製
空中客车	空中巴士
吞并	吞併
棱登	稜登
晨钟	晨鐘
钑	鈒
狄志杰	狄志杰
干霍乱	乾霍亂
丑妇	醜婦
占毕	佔畢
白皮松	白皮松
所有只	所有只
扎下	紮下
扎上	紮上
形而上學	形上學
簖	籪
下签了	下簽了
选手表达	選手表達
海干	海乾
钉	釘
理发展	理發展
心系德	心繫德
尽可能	儘可能
噪诈	譟詐
雇工	僱工
䏝	膞
摭采	摭採
于越	于越
饥饱	饑飽
休征	休徵
制造	製造
黄	黃
黉	黌
迷蒙	迷濛
洒淅	洒淅
十个	十個
捲煙	捲菸
郁卒	鬱卒
郁南	鬱南
正官庄	正官庄
黡	黶
庄司	庄司
黪	黲
黩	黷
沈河	瀋河
钅	釒
面饼	麵餅
面饺	麵餃
报道	報導
舞后	舞后
欤	歟
欧	歐
·威爾士	·威爾士
𪩘	巘
石英钟表	石英鐘錶
痨	癆
痫	癇
痪	瘓
行人路权	行人路權
痳	痲
胡里胡涂	胡裡胡塗
系于一发	繫於一髮
求签	求籤
痉	痙
痈	癰
芸薹	蕓薹
痖	瘂
痒	癢
矜夸	矜誇
肉丝面	肉絲麵
馔	饌
馕	饢
扰	擾
馐	饈
馑	饉
馒	饅
鉴	鑒
官历史	官歷史
数字信号	數位訊號
馄	餛
馅	餡
馆	館
馇	餷
馀	餘
执	執
馂	餕
馃	餜
制革	製革
池里	池裡
馎	餺
扩	擴
馈	饋
馉	餶
扬	揚
馋	饞
扑	撲
帘子	帘子
鸟栖市	鳥栖市
7余	7餘
卤鸭	滷鴨
被里	被裡
跳荡	跳蕩
卤鸡	滷雞
游冶	遊冶
雕心雁爪	鵰心雁爪
课征	課徵
巴巴多斯	巴貝多
征象	徵象
仆少	僕少
雕翎	鵰翎
穆棱	穆稜
斗兽	鬥獸
新历	新曆
咸猪	鹹豬
仆射	僕射
逆风后	逆風後
朝鲜于	朝鮮於
推情准理	推情準理
涌向	湧向
漕挽	漕輓
划到岸	划到岸
的回复	的回覆
㤘	㥮
沈水	瀋水
拔发	拔髮
尸棄佛	尸棄佛
4天后	4天後
姗	姍
咬姜呷醋	咬薑呷醋
氨基酸	胺基酸
栖栖皇皇	栖栖皇皇
上课钟	上課鐘
姹	奼
’	』
‘	『
六周后	六周後
李志喜	李志喜
“	「
发带	髮帶
舍实	捨實
发松	發鬆
捉奸	捉姦
水表面	水表面
南京钟表	南京鐘錶
烟卷	煙捲
戛纳	坎城
胡梢	鬍梢
精辟	精闢
卷心菜	捲心菜
夸赞	誇讚
一出悲剧	一齣悲劇
腑脏	腑臟
素发现	素發現
复本	複本
万签插架	萬籤插架
四分历史	四分歷史
钟声	鐘聲
大只是	大只是
夸起	誇起
后安路	后安路
依依不舍	依依不捨
斗彩	鬥彩
好勇斗狠	好勇鬥狠
钟壁	鐘壁
伊利诺伊州	伊利諾州
單于	單于
累瓦结绳	纍瓦結繩
寄托	寄託
十出击	十出擊
动	動
首席财务官	財務長
凶横	兇橫
务	務
劢	勱
势	勢
拉克施尔德钟	拉克施爾德鐘
干枯	乾枯
劲	勁
劳	勞
宽松松	寬鬆鬆
一天钟	一天鐘
白面包青天	白面包青天
舰只	艦隻
干果	乾果
撄	攖
胎发育	胎發育
晃荡	晃蕩
引斗	引鬥
复评	複評
借口	藉口
病征	病徵
复词	複詞
后座	后座
复诊	複診
踌	躊
新干县	新幹縣
复试	複試
有只允	有只允
克薄	剋薄
0只	0隻
小只在	小只在
陈有后	陳有后
半只够	半只夠
后庄	后庄
踪	蹤
踯	躑
五余	五餘
踬	躓
取舍	取捨
饥民	饑民
面筋	麵筋
复课	複課
伊丽莎白	伊莉莎白
吊民	弔民
关系统	關系統
夸能斗智	誇能鬥智
系到	繫到
不负所托	不負所托
剖厘	剖釐
影后	影后
棉制	棉製
准话	準話
搏斗	搏鬥
豆干	豆乾
面包扎	面包紮
蒙混	矇混
德累斯顿	德勒斯登
残肴	殘肴
包准	包準
卷毛	捲毛
历史里	歷史裡
苍郁	蒼鬱
襕	襴
舍己从人	捨己從人
卷风	捲風
钟点	鐘點
荡涤	蕩滌
松溪县	松谿縣
戴克里先	戴克里先
斗成	鬥成
于雲鶴	于雲鶴
额我略历	額我略曆
凶巴巴	兇巴巴
能干扰	能干擾
游宦	遊宦
复比	複比
夸得	誇得
盘	盤
分钟	分鐘
有只不	有只不
丑巴怪	醜巴怪
征咎	徵咎
磁盘	磁碟
反煙	反菸
解像度	解析度
張三丰	張三丰
钟体	鐘體
毛里裘斯	模里西斯
县志	縣誌
犸	獁
犹	猶
状	狀
犷	獷
干粉	乾粉
空荡荡	空蕩蕩
子云	子云
云云	云云
角落发	角落發
石勒苏益格	什勒斯維希
那卷	那捲
铁钟	鐵鐘
大只可	大只可
干粮	乾糧
宇宙志	宇宙誌
突尼斯	突尼西亞
金表露	金表露
余威	餘威
厘清	釐清
0杆	0桿
汉	漢
遥	遙
甜面酱	甜麵醬
辟建	闢建
汇	匯
二周后	二周後
刻多钟	刻多鐘
鸩	鴆
烟丝	菸絲
二天后	二天後
教范	教範
范文澜	范文瀾
半只可	半只可
𫄸	纁
鸬	鸕
生姜	生薑
抓斗	抓斗
范文芳	范文芳
乱哄哄	亂鬨鬨
𫄷	繶
汤	湯
𫄨	絺
所占算	所占算
党项	党項
户	戶
𫄧	綖
丑八怪	醜八怪
䉤	籔
粜	糶
只身為	只身為
于谨	于謹
迂回	迂迴
点赞	點讚
毗婆尸佛	毗婆尸佛
斗着	鬥著
于谦	于謙
于忠肃集	于忠肅集
要自制	要自制
秀发展	秀發展
埃里溫	葉里溫
个月里	個月裡
历尾	曆尾
已占算	已占算
补注	補註
于双戈	于雙戈
家伙	傢伙
粪	糞
小井里	小井里
鸿	鴻
鹅	鵝
游方	遊方
鹇	鷳
鹆	鵒
簡筑翎	簡筑翎
游廊	遊廊
鹃	鵑
鹂	鸝
鹍	鵾
鹌	鵪
鹏	鵬
鹎	鵯
鹉	鵡
鹈	鵜
鹋	鶓
鹊	鵲
十出頭	十出頭
挑斗	挑鬥
鹗	鶚
鹖	鶡
鹑	鶉
鹐	鵮
鹓	鵷
鹒	鶊
鹝	鷊
皆可作淀	皆可作澱
鹟	鶲
鹞	鷂
连采	連採
鹘	鶻
鹛	鶥
鹚	鶿
鹥	鷖
鹤	鶴
鹧	鷓
鹦	鸚
鹡	鶺
心系天	心繫天
鹣	鶼
鹢	鷁
鹭	鷺
鹬	鷸
鹯	鸇
发签	發籤
加沙地带	加薩走廊
余音	餘音
鹫	鷲
鹪	鷦
柳斌杰	柳斌杰
鹴	鸘
南朝鲜	南韓
鹱	鸌
鹰	鷹
圣卢西亚	聖露西亞
阿拉伯撒哈拉	撒拉威阿拉伯
鹾	鹺
加沙地帶	加薩走廊
东岳	東嶽
遮丑	遮醜
斗牙斗齿	鬥牙鬥齒
精致	精緻
托词	託詞
高干扰	高干擾
夹裙	袷裙
子里	子裡
布殊	布希
理发生	理發生
蒙胧	朦朧
怀钟	懷鐘
馬爾代夫	馬爾地夫
員山庄	員山庄
五脏	五臟
健力士世界纪录	金氏世界紀錄
必须	必須
瑙鲁	諾魯
能干涉	能干涉
冷面	冷麵
于貝爾	于貝爾
观采	觀採
窒欲	窒慾
只身上无	只身上無
刹	剎
图鉴	圖鑑
发菜	髮菜
拔须	拔鬚
好斗膽	好斗膽
黑干将	黑幹將
吃姜	吃薑
系风捕影	繫風捕影
旁注	旁註
购并	購併
面汤	麵湯
征才	徵才
曰云	曰云
山里有	山裡有
假发	假髮
出乖弄丑	出乖弄醜
胪	臚
于光遠	于光遠
坛子	罈子
于是之	于是之
实累累	實纍纍
霉毒	黴毒
洛钟东应	洛鐘東應
荷花淀	荷花澱
千只可	千只可
手表面	手表面
赶制	趕製
采石磯	采石磯
賭后	賭后
谷物	穀物
辟佛	闢佛
辟作	闢作
征稿	徵稿
奖	獎
𬘓	紃
竹溪县	竹谿縣
磨蝎	磨蝎
塞浦路斯	賽普勒斯
𬘘	紞
奁	奩
䜩	讌
奂	奐
征逐	徵逐
痊愈	痊癒
𬘩	綎
鐵托	狄托
𬘬	綪
𬘭	綝
𬘯	綧
卷帘	捲簾
征选	徵選
征税	徵稅
复读机	複讀機
干群关系	幹群關係
肮	骯
径庭	逕庭
黃杰	黃杰
表征	表徵
吊旗	弔旗
肠	腸
肿	腫
肾	腎
戲院里	戲院里
于和偉	于和偉
采暖	採暖
定准	定準
缝里	縫裡
肃	肅
志哀	誌哀
范金	範金
斗弄	鬥弄
息谷	息穀
扎诈	紮詐
㖞	喎
编余	編餘
南筑	南筑
后发星系团	后髮星系團
尸子	尸子
丁丁当当	丁丁當當
个里	個裡
范数	範數
趱干	趲幹
不克自制	不克自制
咕咕钟	咕咕鐘
飘荡	飄蕩
𬳶	駉
贵征	貴徵
借此	藉此
土制	土製
制冷机	制冷機
趸	躉
交哄	交鬨
皇极历史	皇極歷史
躏	躪
松快	鬆快
淳于	淳于
渐	漸
躜	躦
布基納法索	布吉納法索
郁燠	鬱燠
词汇	詞彙
抱朴而长吟兮	抱朴而長吟兮
大本钟	大本鐘
躯	軀
万历史	萬歷史
茎干	莖幹
斗舰	鬥艦
捍御	捍禦
涌进	湧進
胡髯	鬍髯
胡髭	鬍髭
壮面	壯麵
扎伊爾	薩伊
显示钟	顯示鐘
郁泱	鬱泱
宿舍	宿舍
列奥纳多	李奧納多
老板	老闆
悲凄	悲悽
昆嵛	崑嵛
托付	託付
个中滋味	箇中滋味
旋松	旋鬆
于和伟	于和偉
炼气	鍊氣
熏香	薰香
烟草	菸草
图瓦卢	吐瓦魯
复函数	複函數
许愿起经	許愿起經
调钟表	調鐘錶
亿余	億餘
瑸	璸
烟鬼	菸鬼
瑶	瑤
表王	錶王
黾	黽
牵一发	牽一髮
国际象棋	西洋棋
准备	準備
雾	霧
高清电视	高畫質電視
致密	緻密
中签约	中簽約
揽	攬
刮大风	颳大風
呦喂	呦喂
𫫇	噁
捵面	捵麵
沙律	沙拉
单干	單幹
回文结构	迴文結構
心系湖	心繫湖
卤好	滷好
烧干	燒乾
躁郁	躁鬱
干吏	幹吏
卖断发	賣斷發
走回路	走回路
筵几	筵几
烫一个发	燙一個髮
炖制	燉製
选手表示	選手表示
麻将席	麻將蓆
余项	餘項
丰標不凡	丰標不凡
䦅	鐥
责	責
䦁	𨧜
䦀	𨦫
䦃	鐯
䦂	䥇
发上冲冠	髮上沖冠
4余	4餘
冰山里	冰山裡
䦷	䦟
䦶	䦛
卷缩	捲縮
系数	係數
云为	云為
手表演	手表演
干缺	幹缺
雪里红	雪裡紅
干剥剥	乾剝剝
恶心	噁心
合伙	合夥
中签证	中簽證
非常准	非常準
批准确定	批准確定
发状	髮狀
贴	貼
沙琅	沙瑯
贳	貰
释	釋
震栗	震慄
于鬯	于鬯
草席	草蓆
系为	係為
吟游	吟遊
斗志	鬥志
贻	貽
下签收	下簽收
的图里	的圖裡
明窗净几	明窗淨几
污蔑	污衊
钟塔	鐘塔
红钟	紅鐘
沉淀	沉澱
刾	㓨
杆弟	桿弟
刽	劊
水里溪	水里溪
霉气冲天	霉氣衝天
告里	告裡
手表现	手表現
须毛	鬚毛
删	刪
发短心长	髮短心長
刬	剗
刭	剄
从仆	從僕
别	別
从里到外	從裡到外
划	劃
面包圍	面包圍
刚	剛
创	創
刘	劉
则	則
黑发	黑髮
了然后	了然後
百科里	百科裡
刍	芻
泱郁	泱鬱
个中奥	箇中奧
苧烯	薴烯
其次辟地	其次辟地
凭准	憑準
表面包	表面包
朴重	樸重
朴野	樸野
合并	合並
于韋斯屈萊	于韋斯屈萊
公共交通	公共運輸
揩干	揩乾
干冷	乾冷
欧游	歐遊
遗	遺
𬮱	闉
关系	關係
断发现	斷發現
蒙聩	矇聵
干冰	乾冰
幅图里	幅圖裡
铽	鋱
觞	觴
斯威士蘭	史瓦帝尼
厘整	釐整
觐	覲
觑	覷
觎	覦
觏	覯
觌	覿
觍	覥
觊	覬
觋	覡
𨑹	䢨
觉	覺
视	視
觇	覘
规	規
觅	覓
观	觀
觃	覎
分辨率	解析度
称	稱
松土	鬆土
准保护	准保護
数字钟	數字鐘
涂醒哲	涂醒哲
干干净净	乾乾淨淨
只身边	只身邊
卷须	卷鬚
秽	穢
于吉	于吉
勾心斗角	勾心鬥角
触	觸
这出现	這出現
口干政	口干政
炮制	炮製
秾	穠
夸张	誇張
風后	風后
鉴戒	鑑戒
伯利兹	貝里斯
荡荡	蕩蕩
中风后	中風後
能干休	能干休
有征讨	有征討
发状态	發狀態
谷壳	穀殼
汤下面	湯下麵
回文数	迴文數
揪采	揪採
胜键	胜鍵
花菴词选	花菴詞選
脶	腡
施舍之道	施舍之道
脱	脫
采收	採收
数只含	數只含
结扎	結紮
脸	臉
𣎑	臗
斗趣	鬥趣
弘历史	弘歷史
特制止	特制止
向迩	嚮邇
征迹	徵跡
风范	風範
脓	膿
脑	腦
困倦起来	困倦起來
好家伙	好傢夥
脚	腳
佣金	傭金
表带	錶帶
轩辟	軒闢
下签证	下簽證
六扎	六紮
脍	膾
脾脏	脾臟
被废后	被廢後
脉	脈
周惠后	周惠后
余切	餘切
𠉂	㒓
余刃	餘刃
尸禄	尸祿
只影响	只影響
敌忾同仇	敵愾同讎
云须	雲鬚
归并	歸併
高度自制	高度自制
𠉗	𠏢
夜里	夜裡
历纪	曆紀
鞋里	鞋裡
朱理安历史	朱理安歷史
先采	先採
制贩	製販
避孕套	保險套
缘	緣
上签订	上簽訂
缚	縛
缛	縟
缜	縝
览	覽
缞	縗
缟	縞
缐	線
缑	緱
缒	縋
缓	緩
缔	締
缕	縷
编	編
缗	緡
缈	緲
缉	緝
缊	縕
缋	繢
缌	緦
缍	綞
缎	緞
缏	緶
缀	綴
缁	緇
缂	緙
缃	緗
缄	緘
缅	緬
缆	纜
缇	緹
心系新	心繫新
闲游	閒遊
并案	併案
朴厚	樸厚
缰	韁
缱	繾
缲	繰
缳	繯
缴	繳
埃里温	葉里溫
缨	纓
缩	縮
缪	繆
缫	繅
缬	纈
岩松了	岩松了
缮	繕
缯	繒
缠	纏
缡	縭
新几内亚	紐幾內亞
见	見
缤	繽
缥	縹
缦	縵
缧	縲
鿏	䥑
鿎	䃮
崖广	崖广
回历史	回歷史
愿樸	愿樸
荐饥	荐饑
鿔	鎶
不斗胆	不斗膽
携	攜
搅	攪
于田	于田
面店铺	面店鋪
搁	擱
合历史	合歷史
搂	摟
棱锥	稜錐
荐饑	荐饑
年谷	年穀
详征博引	詳徵博引
棱缝	稜縫
眼眶里	眼眶裡
内面包	內面包
瓯	甌
鉴古	鑑古
瓒	瓚
准平原	準平原
觯	觶
依托	依託
颤栗	顫慄
别气	彆氣
水里濁水溪	水里濁水溪
塞黑	塞蒙
丝制	絲製
计	計
夏游	夏遊
委托书	委託書
讣	訃
金范	金範
𫭟	塸
据	據
对准钟	對準鐘
学	學
隶	隸
讥	譏
换	換
捣	搗
难	難
认	認
捞	撈
损	損
捝	挩
校舍	校舍
讦	訐
日里	日裡
随	隨
朴学	樸學
余江	餘江
钟速	鐘速
讨	討
年里	年裡
阴干	陰乾
𩠏	𩞦
讪	訕
兆余	兆餘
训	訓
西历	西曆
朴父	樸父
签条	籤條
讯	訊
𩠊	𩜵
公寓里弄	公寓里弄
伊斯坦布尔	伊斯坦堡
炼金	鍊金
托命	託命
人数只	人數只
讵	詎
顺钟向	順鐘向
沥干	瀝乾
壮	壯
业余	業餘
懔栗	懍慄
口钟	口鐘
城里	城裡
壶	壺
发式	髮式
壳	殼
许	許
扫荡	掃蕩
壸	壼
5杆	5桿
钟罩	鐘罩
台灯	檯燈
二只得	二只得
干眼	乾眼
注释	注釋
卤汁	滷汁
古語云	古語云
注里	註裡
林钟	林鐘
涸干	涸乾
字汇	字彙
神雕	神鵰
㳡	濄
淑范	淑範
才干休	才干休
庑	廡
勃兰登堡	布蘭登堡
准头	準頭
库	庫
龙须	龍鬚
漢诺威	漢諾瓦
么二三	么二三
张三丰	張三丰
叮叮当当	叮叮噹噹
鬅松	鬅鬆
雪里蕻	雪裡蕻
杆秤	桿秤
系于	繫於
心系老	心繫老
于素秋	于素秋
得克薩斯	德克薩斯
咸粥	鹹粥
冲	沖
决	決
况	況
这出身	這出身
脺脏	脺臟
庄	莊
正在叱咤	正在叱咤
这只应	這只應
那只会	那只會
写	寫
军	軍
乍得	查德
冷面杀手	冷面殺手
蛋白发	蛋白發
壸范	壼範
冈	岡
册	冊
西井里	西井里
内	內
采食	採食
总数里	總數裡
农历史	農歷史
采风	採風
郁火	鬱火
鲘	鮜
范贤惠	范賢惠
从里向外	從裡向外
几子	几子
不谷	不穀
后妃	后妃
會干擾	會干擾
中签收	中簽收
制糖	製糖
𣭤	𣯴
余三胜	余三勝
六冲	六衝
干掉	幹掉
互联网络	網際網路
峇里海	峇里海
湘累	湘纍
饥寒	饑寒
郁江	鬱江
扎营	紮營
吹干	吹乾
秀发布	秀發布
余姚	餘姚
白霉	白黴
滑借	滑藉
虫	蟲
虮	蟣
屯扎	屯紮
对折	對摺
凿	鑿
拉面部	拉面部
虽	雖
虾	蝦
虿	蠆
自觉自愿	自覺自愿
沾化	霑化
颂系	頌繫
虏	虜
虑	慮
芦	蘆
吊鹤	弔鶴
虚	虛
用法里	用法裡
尼日利亚	奈及利亞
筑北	筑北
尼日利亞	奈及利亞
黄岩区	黃巖區
游说	遊說
忠仆	忠僕
余角	餘角
干营生	幹營生
无梁楼盖	無樑樓蓋
折尺	摺尺
理发表	理發表
𩽾	鮟
凯	凱
𩽼	鯶
𩽽	𩶱
𩽺	𩵩
𩽻	𩵹
𩽹	魥
语汇	語彙
克扣	剋扣
𥬞	籋
乔治·奥威尔	喬治·歐威爾
千只	千隻
辟辟	闢辟
短发	短髮
空钟	空鐘
哟喂	喲喂
余食	餘食
采购	採購
余风	餘風
克期间	克期間
睡游病	睡遊病
浔	潯
浕	濜
酽	釅
浓	濃
浐	滻
昂山素季	翁山蘇姬
酱	醬
酰	醯
单反相机	單眼相機
浆	漿
浇	澆
脔	臠
悉尼	雪梨
浃	浹
济	濟
浏	瀏
赤术	赤朮
骨干	骨幹
浊	濁
松散	鬆散
浈	湞
浉	溮
燕游	燕遊
酝	醞
斗百草	鬥百草
脐	臍
乌冬面	烏龍麵
龟鉴	龜鑑
酂	酇
鲔	鮪
干个够	乾個夠
薄幸	薄倖
羡	羨
数只须	數只須
薄干	薄幹
吊奠	弔奠
凶手	兇手
垒	壘
枝干	枝幹
䅪	𥢢
干熬	乾熬
残余	殘餘
0周后	0周後
厄瓜多	厄瓜多
形单影只	形單影隻
之托	之託
磽确	磽确
干着	幹著
䅉	稏
回廊	迴廊
浩浩荡荡	浩浩蕩蕩
于大寶	于大寶
齑	齏
齐	齊
断	斷
御寇	禦寇
斩	斬
十出祁山	十出祁山
沈大高速	瀋大高速
庄內	庄內
冬游	冬遊
脏	髒
御寒	禦寒
两虎共斗	兩虎共鬥
𫰛	娙
蓬松松	蓬鬆鬆
素朴	素樸
曲钱	麴錢
斋	齋
于國治	于國治
百只怕	百只怕
齿	齒
炼度	鍊度
干撇下	乾撇下
茅于軾	茅于軾
垄	壟
没折至	沒摺至
拿不准	拿不準
逆钟向	逆鐘向
个	個
涌出	湧出
花钟	花鐘
斗气	鬥氣
斗垮	鬥垮
衝着	衝着
進制	進制
软件	軟體
七周后	七周後
旷	曠
从图里	從圖裡
墓志	墓誌
那只能	那只能
晚钟	晚鐘
5天后	5天後
周历史	周歷史
郁林	鬱林
䇲	筴
托古讽今	託古諷今
千天后	千天後
丝	絲
船只	船隻
袋里	袋裡
中签	中籤
舍本逐末	捨本逐末
业	業
面浆	麵漿
王鉴	王鑑
暗沟里	暗溝裡
升州	昇州
余绪	餘緒
钟座	鐘座
专	專
英文里	英文裡
丢丑	丟醜
斯特劳斯	史特勞斯
周游	週遊
康涅狄格	康乃狄克
零余	零餘
夸你	誇你
单向	單向
不采	不採
恶仆	惡僕
上落客	上下客
草荐	草荐
9周后	9周後
拉纤	拉縴
涌泉	湧泉
头发现	頭發現
万	萬
有只采	有只採
余利	餘利
𪉔	𪄆
夏后氏	夏后氏
斗饤	鬥飣
塆	壪
购买欲	購買慾
松山庄	松山庄
悸栗	悸慄
算历	算曆
世纪钟表	世紀鐘錶
赶面棍	趕麵棍
色长发	色長髮
姜汤	薑湯
煙捲	菸捲
扎寨	紮寨
斗败	鬥敗
弹珠台	彈珠檯
万维网	全球資訊網
膑	臏
姜汁	薑汁
悠游	悠遊
下签字	下簽字
蒙松雨	矇松雨
二老板	二老板
径往	逕往
四扎	四紮
倛丑	倛醜
余力	餘力
治愈	治癒
鸡蛋里挑骨头	雞蛋裡挑骨頭
郁朴	郁樸
只身体	只身體
余一	餘一
什锦面	什錦麵
吊恤	弔恤
埃菲尔	艾菲爾
憑几	憑几
满满当当	滿滿當當
可鉴	可鑑
干躁	乾躁
停停当当	停停當當
回复说	回覆說
辑	輯
辐	輻
输	輸
辒	轀
辕	轅
鹤发	鶴髮
辗	輾
辖	轄
亚拉巴马	阿拉巴馬
辘	轆
辚	轔
复赛	複賽
量不准	量不準
辁	輇
辀	輈
较	較
辂	輅
云吞	雲吞
辄	輒
辇	輦
辆	輛
辉	輝
辈	輩
辋	輞
余下	餘下
辍	輟
辌	輬
辏	輳
缝	縫
擦干	擦乾
机床	工具機
斗茶	鬥茶
边	邊
辽	遼
舍我其谁	捨我其誰
达	達
电表	電錶
辩	辯
辫	辮
凶相	兇相
诗余	詩餘
咸度	鹹度
熏染	薰染
涂尔干	涂爾幹
有只	有隻
最多只	最多只
退伙	退夥
锈病	銹病
万余	萬餘
于欣	于欣
夸了	誇了
么氏	么氏
经有云	經有云
心系您	心繫您
游船	遊船
郁热	鬱熱
飞行钟	飛行鐘
尽是	儘是
扑作教刑	扑作教刑
睾	睪
托交	託交
点个赞	點個讚
图里的	圖裡的
𪣻	塿
碗里	碗裡
中签字	中簽字
确瘠	确瘠
7只支持	7只支持
睑	瞼
柜里	櫃裡
赋范	賦范
睁	睜
着	著
尽快	儘快
整出电影	整齣電影
有只是	有只是
零周后	零周後
東南亞國家聯盟	東南亞國家協會
余泽	餘澤
二極管	二極體
约翰斯顿岛	強斯頓環礁
钟身	鐘身
扶余	扶餘
余波	餘波
奧巴馬	歐巴馬
阳	陽
阶	階
于漢超	于漢超
阴	陰
家里	家裡
阊	閶
阋	鬩
阈	閾
阉	閹
阎	閻
阏	閼
阌	閿
阍	閽
阂	閡
阃	閫
阀	閥
纡郁	紆鬱
帕特里克	派屈克
鲽	鰈
阄	鬮
阅	閱
阚	闞
阛	闤
阘	闒
阙	闕
松气	鬆氣
女仆	女僕
阒	闃
阓	闠
阐	闡
阑	闌
阖	闔
阗	闐
阔	闊
阕	闋
勃蘭登堡	布蘭登堡
英聯邦	大英國協
扁拟谷盗虫	扁擬穀盜蟲
云南个旧	雲南箇舊
斗蟋蟀	鬥蟋蟀
七杆	七桿
种師道	种師道
系上。	繫上。
䢁	𨊸
之二只	之二只
䢂	𨋢
历室	曆室
搤肮	搤肮
斗犬	鬥犬
游美学务	遊美學務
船钟	船鐘
心系哪	心繫哪
儿	兒
缭	繚
后发FK型星	后髮FK型星
肖斯塔科维奇	蕭士塔高維奇
古人有云	古人有云
滞	滯
滟	灩
面包装	面包裝
好斗篷	好斗篷
滗	潷
制表键	製表鍵
面包裝	面包裝
茂都淀	茂都澱
阿联酋	阿聯
缢	縊
戬谷	戩穀
缣	縑
谷草	穀草
谷粒	穀粒
有余	有餘
滪	澦
面包裹	面包裹
劉芸后	劉芸后
滠	灄
木签	木籤
滢	瀅
滤	濾
滥	濫
滦	灤
钟好	鐘好
丑人	醜人
部落发	部落發
英联邦	大英國協
抽干	抽乾
干什么	幹什麼
自由钟	自由鐘
高涌泉	高涌泉
素发生	素發生
道琼斯	道瓊
蓬发	蓬髮
丑化	醜化
秃妃之发	禿妃之髮
昆山	崑山
固征	固徵
译制	譯製
回复意见	回覆意見
本杰明	班傑明
夸夸其谈	誇誇其談
奸夫	姦夫
新西蘭	紐西蘭
䲡	鰌
希拉里	希拉蕊
䲠	鰆
纤绳	縴繩
利比里亞	賴比瑞亞
百个	百個
利比里亚	賴比瑞亞
系上黑	繫上黑
献丑	獻醜
斯堪的纳维亚	斯堪地那維亞
皮特凯恩	皮特肯
散伙	散夥
面包揽	面包攬
干食	乾食
累堆	纍堆
长发妹	長髮妹
支配欲	支配慾
难舍	難捨
俭仆	儉僕
涌入	湧入
斗嘴	鬥嘴
斗批改	鬥批改
黄钰筑	黃鈺筑
丑闻	醜聞
肾脏	腎臟
白干儿	白乾兒
信息时代	資訊時代
忠人之托	忠人之托
蹒局	蹣跼
蒙雾露	蒙霧露
母丑	母醜
圖瓦盧	吐瓦魯
昭惠后	昭惠后
铈	鈰
赌后	賭后
搀	攙
小型钟面	小型鐘面
李适	李适
夸毗	誇毗
征集	徵集
雪窗萤几	雪窗螢几
药面儿	藥麵兒
考试制度	考試制度
蛮	蠻
制版	製版
制片	製片
里氏震级	芮氏規模
信息论	資訊理論
一干弟兄	一干弟兄
龙眼干	龍眼乾
姜啤	薑啤
复列	複列
蛲	蟯
蛳	螄
蛰	蟄
蛱	蛺
蛴	蠐
志异	誌異
姜饼	薑餅
蛏	蟶
留长发	留長髮
花药	花葯
鬓	鬢
斗话	鬥話
采珠	採珠
钟顶	鐘頂
节目里	節目裡
独辟蹊径	獨闢蹊徑
征到	徵到
争妍斗奇	爭妍鬥奇
托卖	託賣
危地马拉	瓜地馬拉
油泼面	油潑麵
哗噪	譁噪
万年历表	萬年曆錶
希伯来历史	希伯來歷史
肖邦	蕭邦
空荡	空蕩
萊索托	賴索托
大病初愈	大病初癒
余味	餘味
纤手	縴手
宝里宝气	寶裡寶氣
、面点	、麵點
余8	餘8
余9	餘9
两杆	兩桿
于山國	于山國
府干涉	府干涉
余2	餘2
余3	餘3
余0	餘0
荧屏	螢屏
发霜	髮霜
余7	餘7
余4	餘4
余5	餘5
红发	紅髮
嶒棱	嶒稜
赌台	賭檯
代表	代表
那只应	那只應
鉴定	鑑定
熏风	薰風
喝干	喝乾
姜母	薑母
咎征	咎徵
扑打	扑打
江并流	江併流
馆里	館裡
体里	體裡
奴仆	奴僕
只身份	只身份
克隆人	複製人
告札	告劄
夸别	誇別
不寒而栗	不寒而慄
赍	齎
台州	台州
划了一会	划了一會
烟酒	菸酒
齿落发白	齒落髮白
不斗膽	不斗膽
到山里	到山裡
八余	八餘
克林顿	柯林頓
手折	手摺
向往来	向往來
懔	懍
谷食	穀食
三天后	三天後
虮虱相吊	蟣蝨相弔
舍安就危	捨安就危
雄斗斗	雄斗斗
大周折	大週摺
鳛	鰼
鳚	䲁
鳙	鱅
云里雾里	雲裡霧裡
几周后	幾周後
跌扑	跌扑
鳝	鱔
鳜	鱖
鳓	鰳
鳒	鰜
鳑	鰟
鳐	鰩
鳗	鰻
鳖	鱉
洒濯	洒濯
鳔	鰾
鳋	鰠
鳊	鯿
鳉	鱂
鳈	鰁
克里斯托弗	克里斯多福
鳎	鰨
鳍	鰭
鳌	鰲
炼师	鍊師
鳂	鰃
鳁	鰮
鳀	鯷
鳇	鰉
鳆	鰒
鳅	鰍
鳄	鱷
杠毂	杠轂
攒	攢
2周后	2周後
3只支持	3只支持
夸耀	誇耀
买断发	買斷發
6周后	6周後
缺省	預設
鳣	鱣
鳢	鱧
鳡	鱤
鳠	鱯
注：	註：
鳤	䲘
矿	礦
矾	礬
矶	磯
矫	矯
特别致	特别致
颂赞	頌讚
厘正	釐正
于仲文	于仲文
𪡏	嗹
一干家中	一干家中
𥺅	䊭
准拿督	準拿督
拉面前	拉面前
髮踊沖冠	髮踊沖冠
雪茄煙	雪茄菸
相克服	相克服
玉历	玉曆
鞯	韉
𫑡	鄳
數碼訊號	數位訊號
干劲	幹勁
内制	內製
并线	併線
辟室	闢室
禁欲主义	禁欲主義
铲刈	剷刈
游历	遊歷
码码表	碼碼表
干办	幹辦
面茶	麵茶
澄澹精致	澄澹精致
丑虏	醜虜
鞑	韃
鞒	鞽
上签名	上簽名
金表态	金表態
炸酱面	炸醬麵
凄惋	悽惋
干乔	乾喬
采回	採回
老干	老乾
绕梁	繞樑
鬶	鬹
日历史	日歷史
布隆方丹	布隆泉
气郁	氣鬱
凄惨	悽慘
于非暗	于非闇
波斯尼亚和黑塞哥维那	波士尼亞與赫塞哥維納
寿面	壽麵
忾	愾
忧	憂
未干涉	未干涉
黎吉雲	黎吉雲
霁范	霽範
制衣	製衣
肯尼迪	甘迺迪
硬件	硬體
扑冬	撲鼕
忆	憶
采芹人	採芹人
希拉莉	希拉蕊
忏	懺
天历史	天歷史
干虔	乾虔
猪	豬
采风问俗	採風問俗
于奇库杜克	于奇庫杜克
猫	貓
驻扎	駐紮
面点、	麵點、
横峰县	橫峯縣
盐卤	鹽滷
斗智	鬥智
后稷	后稷
索面	索麵
隽	雋
隆准许	隆准許
积谷防饥	積穀防饑
捡	撿
采信	採信
困斗	困鬥
㛟	𡞵
雙胜類	雙胜類
㛀	媰
达累斯萨拉姆	三蘭港
夜晚里	夜晚裡
啰苏	囉囌
周游列国	周遊列國
奸妇	姦婦
㛿	𡠹
自制服	自制服
面包起	面包起
韦席	韋蓆
㛤	孋
陳杰	陳杰
铆足	卯足
卷动	捲動
斗争斗合	鬥爭鬥合
飘飘荡荡	飄飄蕩蕩
郁陶	鬱陶
协防	協防
移动操作系统	行動作業系統
谛	諦
对准表	對準錶
谙	諳
谘	諮
谟	謨
黃詩杰	黃詩杰
谝	諞
谜	謎
谓	謂
物欲	物慾
卢旺达	盧安達
谐	諧
谗	讒
谖	諼
雅马哈	山葉
谔	諤
谋	謀
谊	誼
谈	談
谏	諫
谎	謊
谍	諜
谌	諶
俦	儔
谂	諗
谁	誰
谀	諛
谇	誶
谆	諄
谅	諒
谄	諂
隐	隱
雅穆蘇克雷	雅穆索戈
控制	控制
栋梁	棟樑
坛𬴃	罈騞
谱	譜
谰	讕
𫭢	埨
径到	逕到
谴	譴
谫	譾
谪	謫
谩	謾
谨	謹
谯	譙
谮	譖
谭	譚
谬	謬
谣	謠
谢	謝
谡	謖
山里的	山裡的
谧	謐
美发学	美髮學
谥	諡
谤	謗
腊味	腊味
锦卤	錦滷
干圆洁净	乾圓潔淨
結他	吉他
坐台铁	坐台鐵
系鞋带	繫鞋帶
面点师	麵點師
赪	赬
涌起	湧起
会吊	會弔
向导	嚮導
怒气冲天	怒氣衝天
马斯特里赫特	馬斯垂克
老懞	老懞
四周后	四周後
席子	蓆子
高干	高幹
𬯀	隮
干子	乾子
更仆难数	更僕難數
蝾	蠑
咸甜	鹹甜
內羅畢	奈洛比
移动网络	行動網路
蝎	蠍
南宮适	南宮适
蝉	蟬
游轮	遊輪
蝇	蠅
瓦努阿图	萬那杜
煙斗	菸斗
干季	乾季
窝里	窩裡
刮倒	颳倒
冲到	衝到
复壁	複壁
压制机	壓製機
赆	贐
小只	小隻
姜蓉	薑蓉
病余	病餘
有征討	有征討
警示钟	警示鐘
并发动	並發動
冲天炮	衝天炮
进制	進制
洁	潔
对表演	對表演
并吞	併吞
旧历	舊曆
通奸	通姦
伙众	夥眾
绷扒吊拷	繃扒弔拷
5余	5餘
并名	併名
赎	贖
聚药雄蕊	聚葯雄蕊
并合	併合
弃舍	棄捨
捆扎	綑紮
腕表	腕錶
伣	俔
疑凶	疑兇
传	傳
伧	傖
伦	倫
伥	倀
冲风	衝風
伫	佇
伪	偽
傥	儻
傧	儐
众	眾
盒里	盒裡
河岳	河嶽
伛	傴
会	會
返朴	返樸
卷纸	捲紙
傩	儺
赗	賵
天后	天后
村落发	村落發
索贊尼辛	索忍尼辛
赓	賡
皇历史	皇歷史
府干扰	府干擾
鬓发	鬢髮
郁垒	鬱壘
𫌨	覼
湾	灣
邱于庭	邱于庭
才干预	才干預
鸡只	雞隻
游子	遊子
多只会	多只會
𫌀	襀
有仆	有僕
烟嘴	菸嘴
知識產權署	知識產權署
回形夹	迴形夾
谷苗	穀苗
话里有话	話裡有話
纮	紘
纯	純
纬	緯
纭	紜
涂逢年	涂逢年
纫	紉
纨	紈
纩	纊
约	約
级	級
纤	纖
涂姓	涂姓
红	紅
𤳄	𤳸
纠	糾
纡	紆
纾	紓
干癣	乾癬
纼	紖
纽	紐
纺	紡
纻	紵
纸	紙
纹	紋
纶	綸
纷	紛
纴	紝
纵	縱
纲	綱
纳	納
纰	紕
纱	紗
庙	廟
干亲	乾親
美发沙龙	美髮沙龍
纟	糹
身体发肤	身體髮膚
护发	護髮
公寓里	公寓裡
残疾人奥林匹克	帕拉林匹克
阴历	陰曆
梿	槤
这伙人	這夥人
历狱	曆獄
玉历史	玉歷史
白净面皮	白淨面皮
䁖	瞜
欲火	慾火
暧	曖
鱽	魛
鱼	魚
鱿	魷
鱾	魢
规范	規範
呵喂	呵喂
黎克特制	黎克特制
剃胡	剃鬍
两只	兩隻
暂	暫
绘制	繪製
寶曆	寶曆
显示表	顯示錶
么元	么元
二不棱登	二不稜登
哄堂大笑	哄堂大笑
吊丧	弔喪
阳历史	陽歷史
钟响	鐘響
么兒	么兒
洋煙	洋菸
五谷	五穀
𨷿	䦳
狂并潮	狂併潮
斗风	鬥風
的山里	的山裡
冗余	冗餘
罗纳德·里根	隆納·雷根
怨气冲天	怨氣衝天
𬣙	訏
片里	片裡
十天后	十天後
𬣞	詝
𬣡	諓
诬蔑	誣衊
石梁	石樑
钟磬	鐘磬
四个	四個
回文诗	迴文詩
𬣳	詪
苑里	苑裡
水里鄉	水里鄉
词余	詞餘
𦛨	朥
声	聲
征婚	徵婚
钟不撞不鸣	鐘不撞不鳴
沈州	瀋州
征询	徵詢
采光	採光
集装箱	貨櫃
长历	長曆
钟律	鐘律
对表中	對表中
伴游	伴遊
赕	賧
煙草	菸草
车里雅宾斯克	車里雅賓斯克
延历	延曆
注标	註標
好丑	好醜
侵并	侵併
鹰鵰	鹰鵰
彻	徹
那只不过	那只不過
埃及艳后	埃及豔后
凭折	憑摺
秋游	秋遊
录	錄
当	當
归	歸
彟	彠
格斗	格鬥
大多只	大多只
里弦	裡弦
𬀪	晛
礼赞	禮讚
刮风	颳風
显示表明	顯示表明
掌上壓	伏地挺身
乞力马扎罗	吉力馬札羅
烫发	燙髮
镜图里	鏡圖裡
布里海	布里海
曲霉	麴黴
腌臢	腌臢
6天后	6天後
村里有	村裡有
粮	糧
制程	製程
燕几	燕几
有事之无范	有事之無範
回游	回遊
采气	採氣
松懈	鬆懈
淬炼	淬鍊
方向	方向
知识产权署	知識產權署
结发	結髮
蝈	蟈
扎铁	紮鐵
肺脏	肺臟
准谱	準譜
俭确之教	儉确之教
借故	藉故
咸味	鹹味
于建嵘	于建嶸
’re	’re
采撷	採擷
只占神问卜	只占神問卜
齿危发秀	齒危髮秀
钱谷	錢穀
光盘	光碟
系列里	系列裡
面码儿	麵碼兒
累绁	纍紲
逋发	逋髮
后豐	后豐
荐臻	荐臻
鄉愿	鄉愿
公干	公幹
游手好闲	遊手好閒
吉凶庆吊	吉凶慶弔
0只支持	0只支持
扑咚	撲鼕
心系高	心繫高
制药	製藥
伊郁	伊鬱
余孽	餘孽
节欲	節慾
卷烟盒	捲煙盒
麹霉	麴黴
美容美发	美容美髮
里海崖	里海崖
口腹之欲	口腹之慾
。个中	。箇中
电钟	電鐘
余子	餘子
咸得	鹹得
带余	帶餘
台子孙	台子孫
毫厘	毫釐
余存	餘存
天文学钟	天文學鐘
签幐	籤幐
饥溺	饑溺
变丑	變醜
端口	埠
转斗千里	轉鬥千里
厘毫	釐毫
木材干馏	木材乾餾
心系北	心繫北
府干预	府干預
斗叶子	鬥葉子
马斯垂克期	馬斯垂克期
正文里	正文裡
迭代	疊代
雪茄烟	雪茄菸
手里剑	手裏劍
𫓧	鈇
余数	餘數
门里	門裡
𫓩	鏦
𫓯	銈
𫓶	鋗
霡	霢
朱笔	硃筆
癞	癩
𫓹	錤
凌蒙初	凌濛初
游刃	遊刃
咯当	咯噹
癣	癬
雇人	僱人
圣基茨和尼维斯	聖克里斯多福及尼維斯
标签	標籤
癫	癲
竹席	竹蓆
于光新	于光新
于式枚	于式枚
地心历表	地心曆表
于魁智	于魁智
熏沐	薰沐
勤仆	勤僕
侥	僥
侧	側
采石之役	采石之役
历元	曆元
侠	俠
侣	侶
系结	繫結
侬	儂
吉布提	吉布地
侨	僑
侪	儕
稀松	稀鬆
心系富	心繫富
干性油	幹性油
苇	葦
辞	辭
嚴云農	嚴云農
债	債
系绳	繫繩
钟楼	鐘樓
腾涌	騰湧
烟农	菸農
划龙舟	划龍舟
經有云	經有云
朴修斯	樸修斯
范文瀾	范文瀾
剃发	剃髮
南回铁路	南迴鐵路
拂钟无声	拂鐘無聲
海淀山後	海淀山後
划龙船	划龍船
能干政	能干政
浮荡	浮蕩
濒	瀕
肯尼亚	肯亞
斗巧	鬥巧
面包着	面包著
茶余	茶餘
准是	準是
于樂	于樂
装折	裝摺
冻	凍
干蛊	幹蠱
采住	採住
战斗	戰鬥
于承惠	于承惠
托身	託身
蒸制	蒸製
症结	癥結
天里	天裡
局蹐	跼蹐
朴讷	樸訥
准星	準星
节余	節餘
斗起	鬥起
郁金	鬱金
后街	后街
于斯塔德	于斯塔德
神雕像	神雕像
𤈶	熉
煮制	煮製
模棱	模稜
心愿	心愿
范賢惠	范賢惠
廢后	廢后
蛇发女妖	蛇髮女妖
断发	斷髮
沿溯	沿泝
金溪县	金谿縣
格里历	格里曆
百炼	百鍊
夸我	誇我
夸成	誇成
气	氣
冯	馮
恒生	恒生
枨	棖
虫部	虫部
愤	憤
臭气冲天	臭氣衝天
庄里	莊裡
卷成	捲成
庐	廬
朱谕	硃諭
仆姑	僕姑
𬭎	鋐
伏几	伏几
𬭊	𨧀
冲州撞府	衝州撞府
余罪	餘罪
光驱	光碟機
𬭛	𨨏
𬭚	錞
叶恭弘	叶恭弘
农	農
敬挽	敬輓
人发指	人髮指
𬭯	䥕
𬭬	鏏
鹄发	鵠髮
𬭩	鎓
，个中	，箇中
𬭤	鍭
征结	徵結
弄松	弄鬆
𬭼	鐩
𬭸	鏻
𬭶	𨭆
𬭳	𨭎
米余	米餘
丑辞	醜辭
斯坦福大学	史丹福大學
腘	膕
二只	二隻
格林美獎	葛萊美獎
呼吁	呼籲
秀发现	秀發現
拉面色	拉面色
咏	詠
丑辱	醜辱
沈丹线	瀋丹線
鸿范	鴻範
沈海高速	瀋海高速
愿	願
么正	么正
蟏	蠨
哗然	譁然
挂历	掛曆
各辟	各闢
拌面	拌麵
喧哗	喧譁
醇朴	醇樸
集游法	集遊法
蒙蒙细雨	濛濛細雨
柜台	櫃檯
呂宋煙	呂宋菸
准据	準據
坛	壇
伊斯坦布爾	伊斯坦堡
碧河里	碧河里
相冲	相衝
卢瓦尔	羅亞爾
复测	複測
葱郁	蔥鬱
冲着	衝着
复流	複流
金城里	金城里
𣆐	曥
特立尼達和多巴哥	千里達托貝哥
游戏	遊戲
伊东怜	伊東怜
于鳳桐	于鳳桐
采给	採給
坏	壞
數碼電視	數位電視
老干部	老幹部
郁愤	鬱憤
栗栗	慄慄
饭团	飯糰
制作	製作
古柯咸	古柯鹹
采挖	採挖
复式	複式
星历史	星歷史
波斯尼亞	波士尼亞
斗头	鬥頭
波斯尼亚	波士尼亞
有回复	有回覆
特立尼达和托巴哥	千里達托貝哥
云吞面	雲吞麵
于敏	于敏
钟乳洞	鐘乳洞
擞	擻
伙同	夥同
扎好	紮好
哥斯达黎加	哥斯大黎加
格范	格範
礼	禮
后丰	后豐
烤干	烤乾
卷住	捲住
割舍	割捨
烫次发	燙次髮
福爾馬林	福馬林
九余	九餘
球杆	球桿
于從濂	于從濂
升平	昇平
坠	墜
哗众	譁眾
昼	晝
显	顯
警钟	警鐘
于荣光	于榮光
余欢	餘歡
雅尔塔	雅爾達
䃅	磾
馬勒當拿	馬拉度納
糕干	糕乾
摸棱	摸稜
余款	餘款
𫶇	嵽
泪干	淚乾
荡来荡去	蕩來蕩去
茅于轼	茅于軾
手表露	手表露
塞舌爾	塞席爾
𢘝	𢣚
种谷	種穀
服务器	伺服器
马格里布	馬格里布
面疙瘩	麵疙瘩
煮面	煮麵
干才	幹才
生发剂	生髮劑
府干預	府干預
挑大梁	挑大樑
拙朴	拙樸
心系功	心繫功
卤湖	滷湖
胡子昂	胡子昂
外制	外製
冲进	衝進
无余	無餘
心系动	心繫動
须发	鬚髮
干拌面	乾拌麵
托里县	託里縣
卤蛋	滷蛋
钸	鈽
钹	鈸
钺	鉞
游动	遊動
钼	鉬
钽	鉭
钾	鉀
舍近求远	捨近求遠
钰	鈺
钱	錢
钲	鉦
钳	鉗
钴	鈷
洪适	洪适
钶	鈳
钷	鉕
担仔面	擔仔麵
钩	鈎
钪	鈧
钫	鈁
钬	鈥
钭	鈄
钮	鈕
钯	鈀
钠	鈉
钡	鋇
钢	鋼
钣	鈑
雇主	僱主
钥	鑰
盗	盜
钧	鈞
钘	鈃
钙	鈣
钚	鈈
钛	鈦
钜	鉅
钝	鈍
钞	鈔
钟	鍾
钐	釤
那只包括	那只包括
钒	釩
钓	釣
钔	鍆
钕	釹
钖	鍚
钗	釵
针	針
钟调	鐘調
钊	釗
钋	釙
钌	釕
钍	釷
钎	釺
钏	釧
辣面	辣麵
钆	釓
钇	釔
简短发	簡短發
小只会	小只會
纳征	納徵
涌来	湧來
宝历	寶曆
斯威士兰	史瓦帝尼
系囚	繫囚
咸肉	鹹肉
冲浪	衝浪
复方	複方
谈征	談徵
謷丑	謷醜
那里	那裡
积谷	積穀
硬盘	硬碟
红绳系足	紅繩繫足
独裁制	獨裁制
𬂩	梜
激光	雷射
廪	廩
𩧪	䮾
滨田里佳子	濱田里佳子
发表	發表
曲道士	麴道士
拧干	擰乾
费米面	費米面
卷铺盖	捲鋪蓋
请托	請託
泰山梁木	泰山梁木
古朴	古樸
缉凶	緝兇
歌钟	歌鐘
办公台	辦公檯
只影	隻影
万俟	万俟
注记	註記
显示表示	顯示表示
心系的	心繫的
诀	訣
髼松	髼鬆
背地里	背地裡
游魂	遊魂
𩧨	駎
𩧩	𩤊
举手表	舉手表
诌	謅
心理	心理
干不了	幹不了
𩧫	駚
蓄发	蓄髮
古迹	古蹟
历日	曆日
后角	后角
𩧬	𩢡
欲令智昏	慾令智昏
𩧮	𩢾
诋	詆
于震前	於震前
佛罗伦萨	佛羅倫斯
电影里	電影裡
卷去	捲去
朴钝	樸鈍
𩧯	驋
皮肤	皮膚
里头	裡頭
㟆	㠏
𩧲	駧
同人志	同人誌
诒	詒
㟜	𡾱
𩧵	𩢴
货	貨
账	賬
败	敗
雕梁画栋	雕樑畫棟
人工智能	人工智慧
诐	詖
贡	貢
至多	至多
贯	貫
贮	貯
购	購
贬	貶
贫	貧
贪	貪
贩	販
质	質
贷	貸
贶	貺
贵	貴
须眉	鬚眉
复辅音	複輔音
贲	賁
贱	賤
贰	貳
贿	賄
贾	賈
贽	贄
贼	賊
马干	馬乾
贺	賀
费	費
贸	貿
𩧻	𩣵
回旋	迴旋
𩧼	𩣺
煙癮	菸癮
鼻准	鼻準
负	負
贞	貞
贝	貝
𢽾	斅
硵	磠
万一只	萬一只
胡须	鬍鬚
電腦網絡	電腦網路
综合征	綜合徵
鬼气冲天	鬼氣衝天
𩨀	騔
该	該
百拙千丑	百拙千醜
烟民	菸民
回采	回採
𩧳	𩢸
乒乓	桌球
积郁	積鬱
心系香	心繫香
征车	徵車
耳余	耳餘
支干	支幹
丑贼生	醜賊生
𩧴	駩
耶加達	雅加達
还采	還採
葱	蔥
采铁	採鐵
诫	誡
打斗	打鬥
調制解調器	數據機
3杆	3桿
松软	鬆軟
回避	迴避
口干冒	口干冒
休克期	休克期
诳	誑
钟王	鐘王
复始	復始
备注	備註
这只需	這只需
才干戈	才干戈
发丝	髮絲
梵高	梵谷
复姓	複姓
林宏岳	林宏嶽
连系	連繫
田子里	田子里
卜云吉	卜云吉
游览	遊覽
硖	硤
轨范	軌範
密歇根	密西根
举	舉
签诗	籤詩
三统历史	三統歷史
村里的	村裡的
为	為
𤊀	𤒎
葉利欽	葉爾欽
临	臨
基干	基幹
丰	豐
暗斗	暗鬥
垅	壠
垆	壚
噙齿戴发	噙齒戴髮
丧	喪
严	嚴
两	兩
面包办	面包辦
丢	丟
拜托	拜託
发蜡	髮蠟
義联	義联
垲	塏
东	東
丛	叢
涂壯勳	涂壯勳
仪范	儀範
一出喜剧	一齣喜劇
与	與
表冠	錶冠
胎发生	胎發生
志庆	誌慶
垦	墾
筑波	筑波
垩	堊
垫	墊
卤料	滷料
心系子	心繫子
𪞝	凙
淀山	澱山
干生子	乾生子
潴	瀦
要冲	要衝
干么	幹麼
潍	濰
潋	瀲
潆	瀠
潇	瀟
个旧市	箇舊市
染殿后	染殿后
潜	潛
柜上	柜上
于國楨	于國楨
欲海	慾海
一伙食	一伙食
雕鹗	鵰鶚
离	離
注销	註銷
中签名	中簽名
厘改	釐改
于荫霖	于蔭霖
么麼	么麼
本拉登	賓拉登
特制订	特制訂
文莱	汶萊
御制	御製
生华发	生華髮
作品里	作品裡
髯胡	髯鬍
蜡祭	蜡祭
新幾內亞	紐幾內亞
禀	稟
心系小	心繫小
禄	祿
禅	禪
舍不得	捨不得
䝙	貙
就里	就裡
𩧿	䮠
么舅	么舅
馆谷	館穀
5周后	5周後
心系我	心繫我
手表达	手表達
吊孝	弔孝
禁欲	禁慾
迈克尔	麥可
𫸩	彄
余殃	餘殃
尝粪	嚐糞
沟谷	溝谷
干饭	乾飯
熏习	薰習
哄笑	鬨笑
朴茨茅斯	樸茨茅斯
谷仓	穀倉
二个	二個
老挝语	寮語
七天后	七天後
丘吉尔	邱吉爾
新西兰	紐西蘭
索尔仁尼琴	索忍尼辛
木偶戏扎	木偶戲紮
余酲	餘酲
聖后	聖后
咚咚鼓	鼕鼕鼓
斗争	鬥爭
心系西	心繫西
山羊胡	山羊鬍
稣	穌
斗了	鬥了
当啷	噹啷
智能卡	智慧卡
港制	港製
干没	乾沒
𬯎	隤
受托	受託
干沟	乾溝
于凌辰	于凌辰
束发	束髮
附注	附註
维特根斯坦	維根斯坦
系紧	繫緊
么妹	么妹
之一只	之一只
手表决	手表決
朴马	樸馬
伊斯兰堡	伊斯蘭瑪巴德
采石矶	采石磯
样范	樣範
𦟗	𦣎
多普勒	都卜勒
面條目	面條目
果子干	果子乾
冲波	衝波
戴安娜	黛安娜
永志不忘	永誌不忘
波里活	寶萊塢
茕	煢
人云	人云
菜坛	菜罈
头长发	頭長髮
茑	蔦
弹子台	彈子檯
东周钟	東周鐘
钟相	鐘相
昆曲	崑曲
㲿	瀇
腐余	腐餘
干逼	乾逼
里带	裡帶
搜索引擎	搜尋引擎
本庄	本庄
径迎	逕迎
万天后	萬天後
构	構
𣸣	濆
窗帘	窗簾
极	極
勋绩	勳績
隆准	隆準
铲除	剷除
枞	樅
枧	梘
枥	櫪
枣	棗
稳健的台风	穩健的台風
哥斯達黎加	哥斯大黎加
枭	梟
枫	楓
枪	槍
于孔兼	于孔兼
郁蓊	鬱蓊
枱	檯
推托之词	推托之詞
采掘	採掘
魏征	魏徵
啮虫	囓蟲
九天后	九天後
诸余	諸餘
𩽿	𩶰
希拉克	席哈克
面包围	面包圍
纪历	紀曆
赞誉	讚譽
米沈	米瀋
扎裹	紮裹
樵采	樵採
回环	迴環
𩐀	䪗
于奇庫杜克	于奇庫杜克
巷里	巷裡
𫗠	餦
也门	葉門
模范三軍	模范三軍
𨀱	𨄣
曲秀才	麴秀才
房里	房裡
趱	趲
近日无仇	近日無讎
丑侪	醜儕
钟盘	鐘盤
趋	趨
山棱	山稜
干儿	乾兒
爰定祥历	爰定祥厤
约翰逊	詹森
斗脚	鬥腳
怜奈	怜奈
风卷残云	風捲殘雲
二里頭	二里頭
准军事	準軍事
九谷	九穀
精制伏	精制伏
𩨌	𩥑
𩨏	䮳
𩨎	龭
𩨉	𩤲
𩨈	騟
𩨋	𩥄
𩨊	騚
𩨅	𩤸
𩨄	騪
𩨇	䮫
𩨆	𩤙
𩨁	䮞
见钟不打	見鐘不打
𩨃	騝
抑制	抑制
余倍	餘倍
母后	母后
摆钟	擺鐘
面糊	麵糊
啷当	啷噹
咸土	鹹土
留尼汪	留尼旺
卤虾	滷蝦
夸多斗靡	誇多鬥靡
幂	冪
复活节历表	復活節曆表
号志	號誌
鞣制	鞣製
地图里	地圖裡
松喉	鬆喉
干等	乾等
鐵杆	鐵桿
风刮	風颳
斗分子	鬥分子
启发式	啟發式
短几	短几
𪻐	瑽
并	並
谬采虚声	謬採虛聲
幸存	倖存
幺	么
广	廣
𫗴	饘
一伙头	一伙頭
被发左衽	被髮左衽
淀解物	澱解物
𫗦	餔
角落里	角落裡
舍生	捨生
个中理由	箇中理由
𫗮	餭
象征	象徵
铸钟	鑄鐘
煴	熅
发癣	髮癬
拚舍	拚捨
𥺇	𥽖
丑样	醜樣
鉴赏	鑑賞
